Underground - Grendel Games 
Toki Tori 2 - Two Tribes
Affordable Space Adventures - KnapNok Games
Star Fox Guard - Nintendo, PlatinumGames
Star Fox Zero - PlatinumGames
Mario Kart 8 DLC Pack 2 - Nintendo
NES Remix 2 - Indies Zero 
Child of Light - Ubisoft Montreal
Cloudberry Kingdom - Pwnee Studios
Pikmin 3 - Nintendo
Disney Planes - Behaviour Interactive
'Spin the Bottle: Bumpie''s Party' - Redgrim AB
Disney DuckTales Remastered - WayForward
XType Plus - PhobosLab
Disney Infinity - Avalanche Software
Freedom Planet - GalaxyTrail
The Fall - Over The Moon
Runbow - 13AM Games
SteamWorld Dig - Image & Form
'Devil''s Third' - Valhalla Game Studios
Pokemon Rumble U - Ambrella
Marvel Avengers: Battle for Earth - Ubisoft Quebec
Family Party: 30 Great Games Obstacle Arcade - Art Co., Ltd.
Xenoblade Chronicles X - Monolith Soft
Captain Toad: Treasure Tracker - Nintendo EAD Tokyo 
FAST Racing NEO - 'Shin''en'
RUSH - Two Tribes
Temple of Yog - CHUDCHUD INDUSTRIES
Minecraft: Wii U Edition - 4J Studios
NES Remix - Indies Zero 
Knytt Underground - nifflas
Shantae: Half-Genie Hero - WayForward
'Shantae and the Pirate''s Curse' - WayForward
CastleStorm - Zen Studios
Dr. Luigi - Arika, Nintendo
Kirby and the Rainbow Curse - HAL Labs
Donkey Kong Country: Tropical Freeze - Retro Studios
Bit.Trip Presents...Runner2: Future Legend of Rhythm Alien - Gaijin Games
Chariot - Frima Studio
Unepic - EnjoyUp Games
F1 Race Stars: Powered Up Edition - Codemasters
Citizens of Earth - Eden Industries
The Cave - Double Fine Productions
Shadow Puppeteer - Sarepta studio
Puddle - Neko Entertainment
Guacamelee! Super Turbo Championship Edition - DrinkBox Studios
Roving Rogue - Padaone Games
Armillo - Fuzzy Wuzzy Games
One Piece: Unlimited World Red - Ganbarion
Star Wars Pinball - Zen Studios
Canvaleon - OXiAB Game Studio
'Wooden Sen''SeY' - Upper Byte
Super Toy Cars - Eclipse Games
Legend of Kay Anniversary - Neon Studios, Kaiko
BADLAND: Game of the Year Edition - Frogmind
Adventures of Pip - TicToc Games
Cube Life: Island Survival - Cypronia
Mutant Mudds Deluxe - Renegade Kid
Pushmo World - Intelligent Systems
Another World: 20th Anniversary Edition - The Digital Lounge
How to Survive - EKO Software
New Super Luigi U - Nintendo
Mighty No. 9 - Inti Creates
Game & Wario - Intelligent Systems
Tokyo Mirage Sessions #FE - Atlus
Mario & Sonic at the Rio 2016 Olympic Games - Nintendo, Sega Sports R&D
Art Academy: Home Studio - Headstrong Games
Shovel Knight - Yacht Club Games
The Legend of Zelda: Breath of the Wild - Nintendo
The Legend of Zelda: Twilight Princess HD - Tantalus, Tantatus, Nintendo
The Amazing Spider-Man - Beenox
Mario vs. Donkey Kong: Tipping Stars - Nintendo, Nintendo Software Technology
Blok Drop U - RCMADIAX
Mutant Mudds: Super Challenge - Renegade Kid
LEGO City Undercover - TT Games
Pokken Tournament - Bandai Namco Games
Need for Speed: Most Wanted U - Criterion Games
Monster Hunter 3 Ultimate - Capcom
Elliot Quest - Ansimuz Games
Pure Chess - VooFoo Studios
Mario Party 10 - Nintendo, Nd Cube
Stick it to the Man! - Zoink!
Abyss - EnjoyUp Games
Kung Fu Rabbit - Neko Entertainment, Bulkypix
Nihilumbra - BEAUTIFUN GAMES SL, BeautiFun Games
Ultratron - Puppy Games, Carbon Games
Scram Kitty and His Buddy on Rails - Dakko Dakko
Resident Evil: Revelations - Capcom
LEGO Batman 2: DC Super Heroes - TT Games
Swords & Soldiers II - Ronimo Games
Swords & Soldiers HD - Two Tribes
Squids Odyssey - The Game Bakers
'Don''t Starve: Giant Edition' - Klei Entertainment
Splatoon - Nintendo
Mario Kart 8 - Nintendo
Wii Fit U - Nintendo
Electronic Super Joy - Michael Todd Games
Wii Sports Club - Nintendo
Rodea the Sky Soldier - Prope, Kadokawa
Sonic Boom: Rise of Lyric - Big Red Button Entertainment
Mass Effect 3: Special Edition - Straight Right
Madden NFL 13 - EA Tiburon
Scribblenauts Unlimited - 5TH Cell
FIFA Soccer 13 - Electronic Arts
ESPN Sports Connection - Ubisoft
Mario Kart 8 DLC Pack 1 - Nintendo
Tengami - Nyamyam
Animal Crossing: amiibo Festival - Nintendo, Nd Cube
Mario & Sonic at the Sochi 2014 Olympic Winter Games - Nintendo, Sega Sports R&D
'Assassin''s Creed III' - Ubisoft Quebec
NBA 2K13 - Visual Concepts
Darksiders II - Vigil Games
Batman: Arkham City - Armored Edition - Rocksteady Studios, WB Games Montreal
'Trine 2: Director''s Cut' - Frozenbyte, Inc.
New Super Mario Bros. U - Nintendo
Tekken Tag Tournament 2: Wii U Edition - Namco Bandai Games
Call of Duty: Black Ops II - Treyarch
Mighty Switch Force! Hyper Drive Edition - WayForward
Skylanders Giants - Vicarious Visions
Little Inferno - Tomorrow Corporation
Sonic & All-Stars Racing Transformed - Sumo Digital
Nintendo Land - Nintendo
ZombiU - Ubisoft Montpellier
Your Shape: Fitness Evolved 2013 - Blue Byte
Nano Assault Neo - 'Shin''en'
'Ninja Gaiden 3: Razor''s Edge' - Team Ninja
Just Dance 4 - Ubisoft Paris
Warriors Orochi 3 Hyper - Omega Force
Chasing Aurora - Broken Rules
SiNG Party - FreeStyleGames
Disney Epic Mickey 2: The Power of Two - Heavy Iron Studios, Junction Point
Transformers Prime: The Game - Now Production
Rabbids Land - Ubisoft Paris
Funky Barn - Tantalus
Tank! Tank! Tank! - Namco Bandai Games
Ben 10: Omniverse - Vicious Cycle
Game Party Champions - Phosphor Games Studio, LLC
Watch Dogs - Ubisoft Romania
'Adventure Time: Explore the Dungeon Because I DON''T KNOW!' - WayForward
Typoman - Brainseed Factory
Mario Tennis: Ultra Smash - Nintendo, Camelot Software Planning
Edge - Two Tribes
The Mysterious Cities of Gold: Secret Paths - Neko Entertainment
Super Smash Bros. for Wii U - Bandai Namco Games
Super Mario 3D World - Nintendo
Paper Mario: Color Splash - Nintendo, Intelligent Systems
Just Dance 2014 - Ubisoft
Art of Balance - 'Shin''en'
Skylanders Swap Force - Vicarious Visions
'Lone Survivor: The Director''s Cut' - Curve Studios, superflat games
Paper Monsters Recut - Mobot Studios LLC
'Yoshi''s Woolly World' - Good-Feel
Just Dance 2016 - Ubisoft
SteamWorld Heist - Image & Form
'Deus Ex: Human Revolution - Director''s Cut' - Eidos Montreal, Straight Right
LEGO Marvel Super Heroes - TT Games
Fatal Frame: Maiden of Black Water - Koei Tecmo Games
Bayonetta - Bee Tribe
Wii Party U - Nd Cube
Sonic: Lost World - Sonic Team
Pac-Man and the Ghostly Adventures - Namco Bandai Games, Monkey Bar Games
Human Resource Machine - Tomorrow Corporation
Stealth Inc 2: A Game of Clones - Curve Digital
Tetrobot and Co. - Swing Swing Submarine
Cosmophony - Moving Player
Axiom Verge - Tom Happ
Rayman Legends - Ubisoft Montpellier
Gunman Clive HD Collection - Horberg Productions
Cubemen 2 - 3 Sprockets
Ice Cream Surfer - Dolores Entertainment SL, Dolores Entertainment
Dungeons & Dragons: Chronicles of Mystara - Iron Galaxy Studios
Jotun: Valhalla Edition - Thunder Lotus Games
'Q.U.B.E. Director''s Cut' - Toxic Games
Teslagrad - Rain Games
Super Mario Maker - Nintendo
The Wonderful 101 - PlatinumGames
Noitu Love: Devolution - Konjak, MP2 Games
Year Walk - Simogo
The Legend of Zelda: The Wind Waker HD - Nintendo, HexaDrive
Bayonetta 2 - PlatinumGames
Skylanders SuperChargers - Vicarious Visions
Severed - DrinkBox Studios
Extreme Exorcism - Golden Ruby Games
Scribblenauts Unmasked: A DC Comics Adventure - 5TH Cell
Hyrule Warriors - Omega Force
