Skullgirls: 2nd Encore - Lab Zero Games
MonsterBag - IguanaBee
Guacamelee! - DrinkBox Studios
Table Mini Golf - Four Door Lemon
Football Manager Classic 2014 - Sports Interactive
A Rose in the Twilight - Nippon Ichi Software
Dead Nation - 
Conception II: Children of the Seven Stars - Spike
Disgaea 3: Absence of Detention - Nippon Ichi Software
Sayonara UmiharaKawase + - Studio Saizensen
Demon Gaze - Experience Inc.
Thomas Was Alone - Mike Bithell
Severed - DrinkBox Studios
Stranger of Sword City - Experience Inc.
Soul Sacrifice - SCE Japan Studio, comcept
Metrico - Digital Dreams
Table Top Racing - Playrise Edge Ltd.
'Dragon''s Crown' - Vanillaware
Sound Shapes - SCEA
Actual Sunlight - 'Will O''Neill, WZO Games'
Disgaea 4: A Promise Revisited - Nippon Ichi Software
Gravity Crash Ultra - Just Add Water
Phantom Breaker: Battle Grounds - Division2
'Akiba''s Trip: Undead & Undressed' - Acquire
Open Me! - SCEI
Dungeon Travelers 2: The Royal Library & the Monster Seal - Aqua Plus
Resident Evil: Revelations 2 - Frima Studio
Sword Art Online: Hollow Fragment - Bandai Namco Games, Aquria
The Walking Dead: A Telltale Games Series - The Complete First Season - Telltale Games
Amnesia: Memories - Idea Factory
Spelunky - Mossmouth
BigFest - On The Metal Ltd
Rainbow Moon - SideQuest Studios
Uncharted: Fight for Fortune - Sony Bend
Earth Defense Force 2: Invaders From Planet Space - Sandlot
Doki-Doki Universe - SCEA
Sorcery Saga: The Curse of the Great Curry God - Zerodiv
Big Sky: Infinity - VooFoo Studios, Boss Baddie
'Oddworld: Munch''s Oddysee HD' - Just Add Water
Terraria - Engine Software
Bit.Trip Presents...Runner2: Future Legend of Rhythm Alien - Gaijin Games
'Oddworld: Stranger''s Wrath HD' - Just Add Water
Sonic & All-Stars Racing Transformed - Sumo Digital
The Legend of Heroes: Trails of Cold Steel - Falcom
Chronovolt - Playerthree
Criminal Girls: Invite Only - Image Epoch, Imageepoch
Surge Deluxe - FuturLab
Dustforce - Hitbox , QLOC
King Oddball - 10tons Ltd, 10tons
Sly Cooper: Thieves in Time - Sanzaru Games
Kick & Fennick - Jaywalkers Interactive
Hot Shots Golf: World Invitational - Clap Hanz
ModNation Racers: Road Trip - SCEA
Jungle Rumble: Freedom, Happiness and Bananas - Disco Pixel
TxK - Llamasoft
Danganronpa: Trigger Happy Havoc - Spike Chunsoft
Toukiden: The Age of Demons - Omega Force
Rocketbirds: Hardboiled Chicken - Ratloop Asia Pte Ltd
Alien Breed - Team 17
BlazBlue: Continuum Shift Extend - Arc System Works
Super Stardust Delta - Housemarque
Escape Plan - Fun Bits
Rayman Origins - UBlart Montpellier
Lumines: Electronic Symphony - Q Entertainment
Uncharted: Golden Abyss - Naughty Dog, Sony Bend
Ultimate Marvel vs. Capcom 3 - Capcom
FIFA Soccer - Electronic Arts
Wipeout 2048 - Studio Liverpool
Virtua Tennis 4: World Tour Edition - Sega
F1 2011 - Codemasters
Michael Jackson The Experience HD - Ubisoft
Little Deviants - Bigbig Studios
Dungeon Hunter: Alliance - Ubisoft
Asphalt: Injection - Ubisoft
Gunslugs - Abstraction Games
Tales From Space: Mutant Blobs Attack - DrinkBox Studios
Plants vs. Zombies - PopCap
Hustle Kings - VooFoo Studios
Ninja Gaiden Sigma Plus - Team Ninja
Touch My Katamari - Bandai Namco Games
Dynasty Warriors Next - Koei, Omega Force
Army Corps of Hell - Entersphere, Inc.
Shinobido 2: Revenge of Zen - Acquire
StarDrone Extreme - Beatshapers
SwapQuest - Constantin Graf
Hyperdevotion Noire: Goddess Black Heart - Sting
htoL#NiQ: The Firefly Diary - Nippon Ichi Software
Ninja Gaiden Sigma 2 Plus - Team Ninja
Woah Dave! - Choice Provisions
Duke Nukem 3D: Megaton Edition - Abstraction Games
Earth Defense Force 2017 Portable - Sandlot
Joe Danger 2: The Movie - Four Door Lemon
Atelier Ayesha Plus: The Alchemist of Dusk - Gust
Atelier Shallie Plus: Alchemists of the Dusk Sea - Gust
Atelier Escha & Logy Plus: Alchemists of the Dusk Sky - Gust
OlliOlli - Tom Hegarty
Grim Fandango Remastered - Double Fine Productions
Nihilumbra - BEAUTIFUN GAMES SL, BeautiFun Games
Dragon Ball Z: Battle of Z - Artdink
Baboon! - Relevo
Lets Fish! Hooked On - SIMS
Child of Light - Ubisoft Montreal
Velocity Ultra - FuturLab
Ar nosurge Plus: Ode to an Unborn Star - Gust
Mobile Suit Gundam: Extreme VS-Force - Lancarse, Bandai Namco Games
Atelier Rorona Plus: The Alchemist of Arland - Gust
Stealth Inc: A Clone in the Dark - Curve Studios
Puddle - Neko Entertainment
Shiren the Wanderer: The Tower of Fortune and the Dice of Fate - Spike Chunsoft
A.W.: Phoenix Festa - Bandai Namco Games
Lost Dimension - FuRyu
Collar x Malice - Otomate
Rogue Legacy - Cellar Door Games
Ratchet & Clank Collection - Mass Media
PixelJunk Monsters: Ultimate HD - Double Eleven
PlayStation Vita Pets - Spiral House
Hyperdimension Neptunia PP: Producing Perfection - Tamsoft
Quell Memento - Fallen Tree Games
Operation Abyss: New Tokyo Legacy - Experience Inc.
Gravity Rush - SCE Japan Studio
Metal Gear Solid HD Collection - Armature Studio
Magical Beat - Arc System Works
Jak and Daxter Collection - Mass Media
Disney Epic Mickey 2: The Power of Two - Blitz Games, Disney Interactive Studios
LEGO Batman 2: DC Super Heroes - TT Games
Grand Kingdom - Spike Chunsoft
Hotline Miami - Abstraction Games, Dennaton
Muramasa Rebirth - Vanillaware
Zero Escape: Zero Time Dilemma - Spike Chunsoft, Chime
Adventures of Mana - Square Enix
Samurai Warriors Chronicles 3 - Omega Force
Tokyo Xanadu - Falcom
OlliOlli2: Welcome to Olliwood - roll7
Oreshika: Tainted Bloodlines - Alfa System
La-Mulana EX - Pygmy Studio
Hatsune Miku: Project Diva f - Sega
MLB 13: The Show - SCEA San Diego Studios
MotorStorm RC - Evolution Studios
MLB 12: The Show - SCEA San Diego Studios
Unit 13 - Zipper Interactive
LEGO Harry Potter: Years 5-7 - 'Traveller''s Tales'
Flame Over - Laughing Jackal
Tokyo Twilight Ghost Hunters - TOYBOX
Reality Fighters - Novarama
Ridge Racer - Namco Bandai Games, Cellius
Hakuoki: Edo Blossoms - Otomate
Soldner-X 2: Final Prototype - SideQuest Studios
Final Fantasy X / X-2 HD Remaster - Virtuos
Luftrausers - Vlambeer
Dead or Alive 5 Plus - Team Ninja
Sumioni: Demon Arts - Acquire
XCOM: Enemy Unknown Plus - Firaxis Games
Damascus Gear: Operation Tokyo - Arc System Works
Deception IV: Blood Ties - Koei Tecmo Games
Destiny of Spirits - Q Entertainment
Trillion: God of Destruction - Compile Heart
Mortal Kombat - NetherRealm Studios
The Caligula Effect - Aquria
Ray Gigant - Bandai Namco Games
God of War Collection - Sanzaru Games, Sanzaru Games, Inc.
Borderlands 2 - Iron Galaxy Studios
MegaTagmension Blanc + Neptune VS Zombies - Compile Heart
Soul Sacrifice Delta - SCE Japan Studio
Jacob Jones and the Bigfoot Mystery: Episode One - A Bump in the Night - Lucid Games
Hakuoki: Kyoto Winds - Idea Factory, Otomate
Operation Babel: New Tokyo Legacy - Experience Inc.
Hyperdimension Neptunia U: Action Unleashed - Tamsoft
'Men''s Room Mayhem' - Sawfly Studios
Table Top Tanks - Devils Details
The Sly Collection - Sanzaru Games
Monster Monpiece - Compile Heart
Lemmings Touch - d3t Ltd
Mind Zero - Zerodiv
Resistance: Burning Skies - Nihilistic
Norn9: Var Commons - Idea Factory, Otomate
CastleStorm - Zen Studios
When Vikings Attack! - Clever Beans
SUPERBEAT: XONiC - Nurijoy
Tales of Hearts R - 7thChord
Senran Kagura: Bon Appetit! - Meteorise
Call of Duty: Black Ops Declassified - Nihilistic
Alien Breed (PS Mobile) - Team 17
Tokyo Tattoo Girls - SUSHI TYPHOON GAMES
Hatsune Miku: Project Diva F 2nd - Sega
The Amazing Spider-Man - Mercenary Technology
Persona 4 Golden - Atlus
Sine Mora - Digital Reality, Grasshopper Manufacture
PlayStation All-Stars Battle Royale - Bluepoint Games
Tearaway - Media Molecule
Dynasty Warriors 8 Empires - Omega Force
Ys: Memories of Celceta - Falcom
Atelier Meruru Plus: The Apprentice of Arland - Gust
'New Little King''s Story' - Konami
Dengeki Bunko: Fighting Climax - Sega, French-Bread
Jet Car Stunts - True Axis
Worms Revolution Extreme - Team 17
Atomic Ninjas - Grip Games
Retro City Rampage - Vblank Entertainment Inc.
Spy Hunter - TT Fusion
Valkyrie Drive: Bhikkhuni - Marvelous Inc.
Corpse Party: Blood Drive - 5pb
Bad Apple Wars - Otomate
Minecraft: PlayStation Vita Edition - 4J Studios, Mojang AB
Senran Kagura Shinovi Versus - Tamsoft, Marvelous AQL
Valhalla Knights 3 - K2
Dokuro - Game Arts
Silent Hill: Book of Memories - WayForward
Superdimension Neptune VS Sega Hard Girls - Compile Heart
Exist Archive: The Other Side of the Sky - Tri-Ace
Code:Realize - Guardian of Rebirth - Otomate
'Zero Escape: Virtue''s Last Reward' - ChunSoft
Street Fighter X Tekken - Capcom
Frobisher Says! - Honeyslug Ltd
Smart as... - XDEV
Super Monkey Ball: Banana Splitz - Marvelous AQL
Orgarhythm - Acquire
Batman: Arkham Origins Blackgate - Armature Studio
Yomawari: Night Alone - Nippon Ichi Software
Freedom Wars - Dimps Corporation, SCE Japan Studio
Proteus - Ed Key and David Kanaga
Need for Speed: Most Wanted - A Criterion Game - Criterion Games
'Assassin''s Creed III: Liberation' - Ubisoft
Ragnarok Odyssey - Game Arts
LEGO The Lord of the Rings - TT Games
Danganronpa Another Episode: Ultra Despair Girls - Spike Chunsoft
The Muppets: Movie Adventures - Virtual Toys
Velocity 2X - FuturLab
Danganronpa 2: Goodbye Despair - Spike Chunsoft
Rayman Legends - Ubisoft Montpellier
KickBeat - Zen Studios
The Legend of Heroes: Trails of Cold Steel II - Falcom
Drive Girls - Tamsoft
Killzone: Mercenary - Guerilla Cambridge
Psycho-Pass: Mandatory Happiness - 5pb
MeiQ: Labyrinth of Death - Compile Heart
Murasaki Baby - Ovosonico
Run Like Hell! - Mass Creation
Real Boxing - Vivid Games
LittleBigPlanet PS Vita - Tarsier Studios, Double Eleven
Mary Skelter: Nightmares - Compile Heart
Criminal Girls 2: Party Favors - Nippon Ichi Software
Frozen Synapse Prime - Double Eleven
'Lone Survivor: The Director''s Cut' - Curve Studios, superflat games
FIFA Soccer 13 - Electronic Arts
Danganronpa V3: Killing Harmony - Spike Chunsoft
Persona 4: Dancing All Night - Atlus, Dingo Inc.
Invizimals: The Alliance - Novarama
Futuridium EP Deluxe - MixedBag Srl
Natural Doctrine - Kadokawa
