Goat Simulator - Coffee Stain Studios
Batman: Arkham Origins Blackgate - Deluxe Edition - Armature Studio
Dark Souls II: Scholar of the First Sin - From Software
Cities in Motion 2 - Colossal Order
Defiance - Trion Worlds
Hearthstone: Heroes of Warcraft - Blackrock Mountain - Blizzard Entertainment
War for the Overworld - Subterranean Games
The Elder Scrolls V: Skyrim VR - Bethesda Softworks
Blacklight: Retribution - Zombie Studios
Minit - Devolver Digital
Hoard - Big Sandwich Games, Inc.
Confrontation - Cyanide
Evoland - Shiro Games
The Elder Scrolls Online - ZeniMax Media
1979 Revolution: Black Friday - N-Fusion Interactive Entertainment Corp., iNK Stories
Blackwood Crossing - PaperSeven
Shadow Harvest: Phantom Ops - Black Lion Studios
Sang-Froid: Tales of Werewolves - Artifice Studio
Signal Ops - Space Bullet Dynamics Corporation
Lords of Football - Geniaware
Enter the Gungeon - Dodge Roll
Quantum Break - Remedy Entertainment
Paradigm - Jacob Janerka
Yooka-Laylee - Playtonic Games
Stellaris: Utopia - Paradox Development Studio
'Hearthstone: Heroes of Warcraft - Journey to Un''Goro' - Blizzard Entertainment
The Franz Kafka Videogame - mif2000
Broforce - Free Lives
Bulletstorm: Full Clip Edition - People Can Fly
Anomaly: Warzone Earth - 11 bit studios
The Wolf Among Us: Episode 3 - A Crooked Mile - Telltale Games
Out of the Park Baseball 13 - Out Of The Park Developments
Age of Empires II: HD Edition - Ensemble Studios, Hidden Path Entertainment
StarDrive 2 - Zero Sum Games
FIRE - Daedalic Entertainment
I Am Bread - Bossa Studios
Extinction - Iron Galaxy Studios
Naval War: Arctic Circle - Turbo Tape Games
ShootMania Storm - Nadeo
Warlock 2: The Exiled - Paradox Interactive
Dead Synchronicity: Tomorrow Comes Today - Fictiorama Studios
The Signal From Tolva - Big Robot Ltd
Masters of Anima - Passtech Games
Legend of Grimrock - Almost Human
Dark Souls III - From Software
Bayonetta - PlatinumGames, Nex Entertainment
Planescape: Torment - Enhanced Edition - Beamdog
The Sexy Brutale - Tequila Works, Cavalier Game Studios
Cosmic Star Heroine - Zeboyd Games
World of Tanks - Wargaming.net
Magicka: Vietnam - Arrowhead Game Studios
Tribes: Ascend - Hi-Rez Studios
Men of War: Condemned Heroes - 1C-Softclub
Stories: The Path of Destinies - Spearhead Games
Tower of Time - Event Horizon Software
Dead In Vinland - CCCP
Mortal Kombat X - High Voltage Software
Mr. Shifty - Team Shifty
Grand Theft Auto V - Rockstar North
Age of Wonders III - Eternal Lords - Triumph Studios
Titan Souls - Acid Nerve
Final Fantasy IX - Square Enix
Goetia - Sushee
'Everybody''s Gone to the Rapture' - The Chinese Room
Aurion: Legacy of the Kori-Odan - 'Kiro''o Games'
Sanctum (2011) - Coffee Stain Studios
Out of the Park Baseball 14 - Out Of The Park Developments
Dead Effect - Dykast Lubomir
Moebius: Empire Rising - Pinkerton Road Studio
Rick and Morty: Virtual Rick-ality - Owlchemy Labs
Superbrothers: Sword & Sworcery EP - Capy Games
Starseed Pilgrim - Droqen
Victoria II: Heart of Darkness - Paradox Development Studio
Dishonored: The Knife of Dunwall - Arkane Studios
Sacred Citadel - Southend Interactive
Trials Fusion - RedLynx
Westerado: Double Barreled - Ostrich Banditos
The Charnel House Trilogy - Owl Cave
Halo: Spartan Strike - 343 Industries, Vanguard Games
Wargame: Red Dragon - Eugen Systems
Life Goes On - Infinite Monkeys
'Broken Sword 5: The Serpents'' Curse - Part II' - Revolution Software
'Stephen''s Sausage Roll' - increpare
Portal 2 - Valve Software
Deep Black: Reloaded - Biart
Papo & Yo - Minority, Minority Media Inc.
The Last Federation - Arcen Games, LLC
Battlezone 98 Redux - Big Boat Interactive
Flinthook - Tribute Games
The Disney Afternoon Collection - Capcom
'Marvel''s Guardians of the Galaxy: The Telltale Series' - Telltale Games
Full Throttle Remastered - Double Fine Productions
'Marvel''s Guardians of the Galaxy - Episode 1: Tangled Up in Blue' - Telltale Games
Shiness: The Lightning Kingdom - Enigami
Black Mirror III: Final Fear - DTP Entertainment, Cranberry Production
Botanicula - Amanita Design
Super Monday Night Combat - Uber Entertainment
Eador: Masters of the Broken World - Snowbird Game Studios
Surgeon Simulator 2013 - Bossa Studios
God Mode - Old School Games
SpeedRunners - DoubleDutch Games
The Banner Saga 2 - Stoic
Melty Blood: Actress Again Current Code - Ecole, French-Bread
P-O-L-L-E-N - Mindfield Games
For the King - IronOak Games
Syberia 3 - Microids
Murderous Pursuits - Blazing Griffin
Runaway: A Twist of Fate - Pendulo Studios
The Next Big Thing - Pendulo Studios
Cargo! The Quest for Gravity - Ice-Pick Lodge
Out of the Park Baseball 15 - 
Convoy - Convoy Games
'Assassin''s Creed Chronicles: China' - Climax Group, Climax Studios
Battlefleet Gothic: Armada - Tindalos Interactive
The Climb - Crytek
Rogue Stormers - Black Forest Games
'Wilson''s Heart' - Twisted Pixel Games
The Tiny Bang Story - Colibri Games
Dead Island: Riptide - Techland
FRACT OSC - Phosfiend Systems
8-Bit Armies - Petroglyph
Lone Survivor - superflat games
'Don''t Starve' - Klei Entertainment
WRC 3: FIA World Rally Championship - Milestone S.r.l
Star Trek The Video Game - Digital Extremes
Crypt of the NecroDancer - Brace Yourself Games
Uncanny Valley - Cowardly Creations
The Walking Dead: A Telltale Games Series - Telltale Games
The Walking Dead: Episode 1 - A New Day - Telltale Games
Risen 2: Dark Waters - Piranha Bytes
UEFA Euro 2012 - EA Canada
A Valley Without Wind - Arcen Games, LLC
'Monaco: What''s Yours Is Mine' - Pocketwatch Games
The Blackwell Epiphany - Wadjet Eye Games
Endless Legend - Amplitude Studios
Dungeons 2 - Kalypso
What Remains of Edith Finch - Giant Sparrow
Pinstripe - Thomas Brush
Frostpunk - 11 bit studios
BattleTech - Harebrained Schemes LLC
The Swords of Ditto - One Bit Beyond
Darkspore - Maxis
Dark Souls II - From Software
Corpse Party - Mages.
Outlast 2 - Red Barrels
The Walking Dead: The Telltale Series - A New Frontier Episode 4: Thicker than Water - Telltale Games
Immortal Redneck - CremaGames, Crema Games
Sniper: Ghost Warrior 3 - City Interactive
39 Days to Mars - 'It''s Anecdotal'
Bullet Witch - Cavia Inc.
IL-2 Sturmovik: Cliffs of Dover - 1C: Maddox Games
Poker Night 2 - Telltale Games
StarDrive - Zero Sum Games
Mars: War Logs - Spiders
Hearthstone: Heroes of Warcraft - Whispers of the Old Gods - Blizzard Entertainment
Hitman - Episode 2: Sapienza - Io Interactive
The Walking Dead: Michonne - Episode 3: What We Deserve - Telltale Games
The Walking Dead: Michonne - A Telltale Miniseries - Skybound LLC
Cornerstone: The Song of Tyrim - Ascension Studios
Scanner Sombre - Introversion Software
Solo - Team Gotham
Light Fall - Bishop Games
Inked - Somnium Games d.o.o.
Hector: Badge of Carnage - Episode 1: We Negotiate With Terrorists - Straandlooper
Binary Domain - Devils Details
Kerbal Space Program - SQUADTeam, Squad
Ori and the Blind Forest: Definitive Edition - Moon Studios
Wailing Heights - Outsider Games
Warhammer 40,000: Dawn of War III - Relic
Expeditions: Viking - Logic Artists
Monster Prom - Beautiful Glitch
The Thin Silence - TwoPM Studios
Leviathan: Warships - Pieces Interactive
Game Dev Tycoon - Greenheart Games
Ys VI: The Ark of Napishtim - Falcom
Broken Age: Act 2 - Double Fine Productions
Verdun - M2H, Blackmill Games
The Perils of Man - IF Games
Offworld Trading Company - Mohawk Games
Neon Chrome - 10tons Entertainment, 10tons
The Detail - Rival Games Ltd
Back in 1995 - Throw the Warped Code Out
Little Nightmares - Tarsier Studios
CAPSIZED - Alientrap
Back to the Future: The Game - Episode IV: Double Visions - Telltale Games
Zack Zero - Crocodile Entertainment
Child of Light - Ubisoft Montreal
The Amazing Spider-Man 2 - Beenox
Daylight - Zombie Studios
The Weaponographist - Puuba
Sniper Elite V2 - Rebellion
Strike Suit Infinity - Born Ready Games
Zeno Clash II - ACE Team
Order of Battle: Pacific - The Artistocrats
Stealth Inc 2: A Game of Clones - Curve Digital
Chroma Squad - Behold Studios
Guns, Gore & Cannoli - Claeys Brothers Arts
Block N Load - Jagex Games Studio
Solarix - Pulsetense Games
The Forest - SKS Games
A Virus Named TOM - Misfits Attic
Take On Mars - Bohemia Interactive
Slain: Back from Hell - Wolf Brew Games
Slime Rancher - Monomi Park
The Long Dark - Hinterland
Tacoma - The Fullbright Company, Fullbright
Redeemer - Sobaka
Yakuza 0 - Ryu ga Gotoku Studios
LIMBO - PLAYDEAD
Pirates of Black Cove - Nitro Games
The Elder Scrolls V: Skyrim - Dawnguard - Bethesda Game Studios
ABZU - Giant Squid
Batman: The Telltale Series - Episode 1: Realm of Shadows - Telltale Games
This Is the Police - Weappy Studio
Batman: The Telltale Series - Telltale Games
The Legend of Heroes: Trails of Cold Steel - Falcom
Death Rally (2012) - Remedy Entertainment
Nom Nom Galaxy - Q-Games
Submerged - Uppercut Games, Uppercut Games Pty Ltd
Overcooked! - Ghost Town Games Ltd.
Fairy Fencer F - Idea Factory
Beyond Eyes - tiger & squid
LawBreakers - Boss Key, Boss Key Productions
MIND: Path to Thalamus - Carlos Coronado
Road Not Taken - Spry Fox
Road to Ballhalla - Torched Hill
'Little King''s Story' - Cingular mMode, Cing
Symphony - Empty Clip Studios
Deponia - Daedalic Entertainment
Divinity: Dragon Commander - Larian Studios Games Ltd
Beatbuddy: Tale of the Guardians - Threaks
Back to Bed - Bedtime Digital Games
Cloud Chamber - Investigate North Aps
'Hellblade: Senua''s Sacrifice' - Ninja Theory
Dead Cells - Motion Twin
Unmechanical - Teotl Studios, Talawa Games
Spelunky - Derek Yu
Guacamelee! Gold Edition - DrinkBox Studios
Papers, Please - Lucas Pope
'Five Nights at Freddy''s' - animdude
Bear With Me: Episode 1 - Exordium Games
Cat Quest - The Gentlebros
Batman: The Enemy Within - The Telltale Series - Telltale Games
Batman: The Enemy Within - Episode 1: The Enigma - Telltale Games
Mega Man Legacy Collection 2 - Capcom, Bullets
Unavowed - Wadjet Eye Games
Rez Infinite - UGA
Monster Hunter: World - Capcom
Legends of Pegasus - Kalypso, Novacore Studios
Shadow Blade: Reload - Dead Mage Studio, Dead Mage
West of Loathing - Asymmetric Publications
We Happy Few - Compulsion Games
Edge (2011) - Two Tribes, Mobigame
Mini Metro - Dinosaur Polo Club
OlliOlli2: Welcome to Olliwood - roll7
Airscape: The Fall of Gravity - Cross-Product
Reigns - Nerial
Sudden Strike 4 - Kite Games
Risen 3: Titan Lords - Piranha Bytes
Hacknet - Orann
'No Man''s Sky' - Hello Games
Darksiders II - Vigil Games
Sleeping Dogs - United Front Games
Iron Brigade - Double Fine Productions
Europa Universalis IV - Paradox Development Studio
Dishonored: The Brigmore Witches - Arkane Studios
Payday 2 - Overkill Software
DeadCore - 5-Bits Games
'Dragon''s Prophet' - Runewaker Entertainment
Dex - Dreadlocks Ltd, Dreadlocks
World of Warcraft: Battle for Azeroth - Blizzard Entertainment
'Death''s Gambit' - White Rabbit Interactive
Betrayer - Blackpowder Games 
IL-2 Sturmovik: Battle of Stalingrad - 1C Game Studios
Starcraft Remastered - Blizzard Entertainment
The Walking Dead: The Telltale Series - The Final Season Episode 1: Done Running - Telltale Games
Phantom Doctrine - CreativeForge Games
No Time to Explain - tiny Build GAMES, tinyBuild
'Tom Clancy''s Ghost Recon Phantoms' - Ubisoft Singapore
Gone Home - The Fullbright Company
War Thunder - Gaijin Entertainment
Worms Clan Wars - Team 17
Space Hulk - Full Control ApS, Full Control
Nidhogg 2 - Messhof
Observer - Bloober Team
'Ken Follett''s The Pillars of the Earth' - Daedalic Entertainment
Minecraft: Story Mode Season Two - Episode 2: Giant Consequences - Telltale Games
Agents of Mayhem - Volition Inc.
Graveyard Keeper - Lazy Bear Games
State of Mind - Daedalic Entertainment
Bastion - Supergiant Games
Age of Empires Online - Gas Powered Games
Grow Up - Ubisoft Reflections
Phantaruk - Polyslash
From Dust - Ubisoft Montpellier
Not Tonight - Panic Barn Ltd
Volume - Mike Bithell
Tales From The Borderlands: Episode 4 - Escape Plan Bravo - Telltale Games
Final Fantasy Type-0 HD - Square Enix
Zombi - Ubisoft Montpellier
Okhlos - Coffee Powered Machine
Blocks That Matter - Swing Swing Submarine
Saints Row IV - Volition Inc.
Race the Sun - Flippfly
The Bureau: XCOM Declassified - 2K Marin
The Golf Club - HB Studios Multimedia
F1 2016 - Codemasters
Thirty Flights of Loving - Blendo Games
Transformers: Fall of Cybertron - High Moon Studios, Mercenary Technologies
'Tom Clancy''s Splinter Cell: Blacklist' - Ubisoft Toronto
Shadowrun: Hong Kong - Harebrained Schemes LLC
Trine 3: The Artifacts of Power - Frozenbyte, Inc.
RymdResa - Morgondag
Gryphon Knight Epic - Cyber Rhino Studios
Counter-Strike: Global Offensive - Valve Software, Hidden Path Entertainment
Galaxy On Fire 2 Full HD - Fishlabs
Shadowgate - Zojoi Studios
The Escapists 2 - Mouldy Toof Studios
Guacamelee! 2 - DrinkBox Studios
Shenmue I & II - Sega, d3t Ltd
Tempest (2015) - 'Lion''s Shade'
'Marvel''s Guardians of the Galaxy - Episode 3: More Than A Feeling' - Telltale Games
Deus Ex: Human Revolution - Nixxes Software
Deus Ex: Mankind Divided - Eidos Montreal, Nixxes Software
Worms W.M.D - Team 17
F1 2018 - Codemasters
'The King''s Bird' - Serenity Forge
Dark Souls: Prepare to Die Edition - From Software
Jagged Alliance: Crossfire - Kalypso
Tiny Troopers - Iceberg Interactive, Kukouri Mobile Entertainment
Mega Man Legacy Collection - Digital Eclipse
Hearthstone: Heroes of Warcraft - The Grand Tournament - Blizzard Entertainment
Grandia II Anniversary Edition - GungHo
Obduction - Cyan Worlds
F1 2017 - Codemasters
Hector: Badge of Carnage - Episode 2: Senseless Acts of Justice - Straandlooper
Super Time Force Ultra - Capy Games
The Journey Down: Chapter Two - SkyGoblin
Pillars of Eternity: The White March - Part 1 - Obsidian Entertainment
Evoland 2: A Slight Case of Spacetime Continuum Disorder - Shiro Games
Crookz: The Big Heist - Skilltree Studios
Party Hard - Pinokl Games
Corpse of Discovery - Phosphor Games
Master of Orion: Conquer the Stars - NGD Studios
PixelJunk Monsters: Ultimate - Double Eleven
Lost Planet 3 - Spark Unlimited
Metro Redux - 4A Games
Dark Souls II: Crown of the Old Iron King - From Software
The Walking Dead: Season Two Episode 5 - No Going Back - Telltale Games
Final Fantasy XIV Online: A Realm Reborn - Square Enix
Sokobond - Alan Hazelden & Harry Lee
Castlevania: Lords of Shadow Ultimate Edition - Mercury Steam
'Sid Meier''s Ace Patrol' - Firaxis Games
The Raven: Legacy of a Master Thief - Ancestry of Lies - KING Art
Lethal League - Reptile
Big Pharma - Twice Circled
Guild Wars 2 - ArenaNet
Mass Effect 3: Leviathan - BioWare
Shelter - Might and Delight
Satellite Reign - 5 Lives Studios
Pro Evolution Soccer 2019 - Konami
Donut County - Ben Esposito
Bad North - Plausible Concept
The Golf Club 2019 featuring PGA Tour - HB Studios Multimedia
Strange Brigade - Rebellion
Achron - Hazardous Software 
The Walking Dead: Episode 3 - Long Road Ahead - Telltale Games
They Bleed Pixels - Spooky Squid Games
Memoria - Daedalic Entertainment
Guardians of Middle-Earth - Monolith Productions
The Chaos Engine (2013) - Abstraction Games
GoD Factory: Wingmen - Nine Dots Studio
To End All Wars - AGEOD
God Eater 2: Rage Burst - Shift, QLOC
XCOM 2: War of the Chosen - Firaxis Games
Absolver - Sloclap
ARK: Survival Evolved - Studio Wildcard
Two Point Hospital - Two Point Studios
Tropico 4 - Haemimont, Haemimont Games
The Sims Medieval: Pirates & Nobles - The Sims Studio
Serious Sam Double D - 'Mommy''s Best Games'
Snapshot - Retro Affect
Mutant Mudds - Renegade Kid
World of Warcraft: Legion - Blizzard Entertainment
Hue - Fiddlesticks Games
The Final Station - tinyBuild, Do My Best Games
Fallout 4: Nuka-World - Bethesda Game Studios
The Turing Test - Bulkhead Interactive
Livelock - Tuque Games
Champions of Anteria - Blue Byte
Ys Seven - Falcom
The Messenger - Sabotage Studio
Aggressors: Ancient Rome - Kubat Software
Naruto to Boruto: Shinobi Striker - CyberConnect2, Soleil
The Baconing - Hothead Games
Stasis - THE BROTHERHOOD
Rememoried - Vladimir Kudelka
The Warlock of Firetop Mountain - Tin Man Games
Life is Strange: Before the Storm - Episode 1: Awake - Deck Nine Games
Battlestar Galactica Deadlock - Black Lab Games
Life is Strange: Before the Storm - Deck Nine Games
Last Day of June - Ovosonico
Shadows: Awakening - Games Farm, Games Farm s.r.o.
APB: Reloaded - Reloaded Productions, Reloaded Games Inc., Reloaded Games
The Crew - Ubisoft Reflections, Ivory Tower
'Tom Clancy''s Rainbow Six Siege' - Ubisoft Montreal
Maize - Finish Line Games
The Dwarves - KING Art, King Art Games
Seven: The Days Long Gone - IMGN.PRO
Game of Thrones: Episode One - Iron From Ice - Telltale Games
Lumino City - State of Play Games
Valhalla Hills - Daedalic Entertainment
Dungeon Souls - Mike Studios
The Old City: Leviathan - PostMod Softworks
Dariusburst: Chronicle Saviours - Pyramid
'Dragon Quest Heroes: The World Tree''s Woe and the Blight Below' - Koei Tecmo Games
Far Cry 3 - Ubisoft Montreal
Forge - Dark Vale Games
'Broken Sword 5: The Serpents'' Curse - Part I' - Revolution Software
Dead State - DoubleBear Productions
Mutant Year Zero: Road to Eden - The Bearded Ladies Consulting
Just Cause 4 - Avalanche Studios
The Council - Episode 5: Checkmate - Big Bad Wolf
The Book of Unwritten Tales: Critter Chronicles - KING Art
Underrail - Stygian Software
Primordia - Wormwood Studios
SteamWorld Dig - Image & Form
Oozi: Earth Adventure - AwesomeGamesStudio, Awesome Games Studio
Speedball 2 HD - Vivid Games
Nuclear Throne - Vlambeer
SUPERHOT VR - SUPERHOT
Destiny 2: Curse of Osiris - Bungie
Battle Princess Madelyn - Causal Bit Games
Gomo - Fishcow Studio
Shadow Tactics: Blades of the Shogun - Mimimi Productions
Dead Rising 4 - Capcom, Capcom Vancouver
Reigns: Her Majesty - Nerial
Ashen - A44
Katamari Damacy REROLL - MONKEYCRAFT Co. Ltd.
Kenshi - Lo-Fi Games
Jagged Alliance: Rage! - HandyGames
Trine 2 - Frozenbyte, Inc.
The Cat Lady - Harvester Games
DiRT Rally - Codemasters
Helldivers - Arrowhead Game Studios
SpellForce 3 - Grimlore Games
Iris.Fall - Next Studio
Hearthstone: Heroes of Warcraft - Goblins Vs. Gnomes - Blizzard Entertainment
Lara Croft and the Temple of Osiris - Nixxes Software
The Sims 4: Get Together - Maxis
OneShot - Team Oneshot
Total War: WARHAMMER - Realm of the Wood Elves - Creative Assembly
Hello Neighbor - Dynamic Pixels
Samurai Gunn - Beau Blyth
The Novelist - Orthogonal Games
Elegy for a Dead World - Popcannibal
Lightning Returns: Final Fantasy XIII - Square Enix
DUSK - New Blood Interactive
A New Beginning: Final Cut - Daedalic Entertainment
The Talos Principle - Croteam
Fallout 4 VR - Bethesda Game Studios
HAWKEN - Adhesive Games, Reloaded Games
Ace of Spades - Jagex Games Studio
Total War: Rome II - Caesar in Gaul - Creative Assembly
Scrolls - Mojang AB
Okami HD - Capcom
Insurgency: Sandstorm - New World Interactive
Battlefield 3: Back to Karkand - EA DICE
FlatOut 3: Chaos & Destruction - Team6 Game Studios, Team 6 Games Studio
Iron Sky: Invasion - Reality Pump
Stick it to the Man! - Zoink!
Teslagrad - Rain Games
Violett - Forever Entertainment S.A., Forever Entertainment
Batman: The Telltale Series - Episode 5: City of Light - Telltale Games
The Little Acre - Pewter Games Studios
GRIS - Nomada Studio
Book of Demons - Thing Trunk
Earth Defense Force: Insect Armageddon - Vicious Cycle
Space Hulk: Deathwing - Streum On Studio
Gorogoa - Jason Roberts, Buried Signal
Finding Paradise - Freebird Games
Below - Capy Games
LISA - Dingaling
NEO Scavenger - Blue Bottle Games
'King''s Quest Chapter 2: Rubble Without a Cause' - The Odd Gentlemen
Hatoful Boyfriend: Holiday Star - Hato Moa
L.A. Noire: The VR Case Files - Rockstar Games
Elite: Dangerous - Frontier Developments
Q.U.B.E. - Toxic Games
Street Fighter X Mega Man - Capcom
The Walking Dead: Season Two - A Telltale Games Series - Telltale Games
The Walking Dead: Season Two Episode 1 - All That Remains - Telltale Games
Turok Remastered - Night Dive Studios
Metal Gear Solid V: Ground Zeroes - Kojima Productions
Last Year: The Nightmare - Elastic Games
Assetto Corsa - Kunos Simulazioni
Star Wars: The Old Republic - LucasArts, BioWare
The Walking Dead: The Telltale Series - A New Frontier Episode 1: Ties That Bind Part One - Telltale Games
The Walking Dead: The Telltale Series - A New Frontier Episode 2: Ties That Bind Part Two - Telltale Games
The Walking Dead: The Telltale Series - A New Frontier - Telltale Games
'PlayerUnknown''s Battlegrounds' - Bluehole, Inc., PUBG Corporation
Bridge Constructor Portal - ClockStone Software
Life is Strange: Before the Storm - Episode 3: Hell is Empty - Deck Nine Games
Postal III - Running With Scissors
Aviary Attorney - Sketchy Logic
Tiny Metal - AREA35
Minecraft: Story Mode - Episode 4: A Block and a Hard Place - Telltale Games
Final Fantasy XII: The Zodiac Age - Square Enix
Wargroove - Chucklefish
Pineapple Smash Crew - RichMakeGame
American Truck Simulator - SCS Software
Sorcery! Parts 1 and 2 - inkle
Cobalt - Oxeye
CALENDULA - Blooming Buds Studio
'Alwa''s Awakening' - Elden Pixels
Diluvion - ArachnidGames
Sprint Vector - Survios
Past Cure - Phantom 8
Two Worlds II - Reality Pump
Apotheon - Alientrap
Game of Thrones: Episode Two - The Lost Lords - Telltale Games
Husk - UndeadScout
Anodyne - Analgesic Productions
The Wolf Among Us: Episode 2 - Smoke and Mirrors - Telltale Games
Deathtrap - NeocoreGames
Grow Home - Ubisoft Reflections
Disgaea PC - Nippon Ichi Software
Agatha Christie: The ABC Murders - Kalypso
Apex Legends - Respawn Entertainment
Dead Space 3 - Visceral Games
Gigantic Army - Astro Port
Castle In The Darkness - Matt Kap
Cities XXL - Focus Home Interactive
XCOM 2 - Firaxis Games
The Darkness II - Digital Extremes
'Bientot l''ete' - Tale of Tales
Special Forces: Team X - Zombie Studios
Dandara - Long Hat House
ASTRONEER - System Era Softworks
Kingdoms of Amalur: Reckoning - Big Huge Games
Shank 2 - Klei Entertainment
Gotham City Impostors - Monolith Productions
Jazzpunk - Necrophone
The LEGO Movie Videogame - TT Games
Splasher - Splashteam
Phoning Home - ION LANDS
Angry Birds VR: Isle of Pigs - Resolution Games
Test Drive Unlimited 2 - Eden
Black Mirror II: Reigning Evil - Cranberry Studios
Jagged Alliance: Back in Action - Kalypso
Fray - Brain Candy
Bleed 2 - BootdiskRevolution
'Sid Meier''s Civilization VI: Rise and Fall' - Firaxis Games
A Case of Distrust - The Wandering Ben
Attack of the Earthlings - Team Junkfish
Rust - Facepunch Studios
Cannon Fodder 3 - 
Evolve - Turtle Rock Studios
Unravel - Coldwood Interactive
Firewatch - Campo Santo
Dying Light: The Following - Techland
'Assassin''s Creed Chronicles: Russia' - Climax Group, Climax Studios
Alone With You - Benjamin Rivers
Dungeons - Realmforge Studios
Aliens: Colonial Marines - Gearbox Software
Harold - Moon Spider Studio
Impire - Cyanide
NaissanceE - Limasse Five
The Escapists - Mouldy Toof Studios
Lucius II - Shiver Games
Sniper Elite 4 - Rebellion
For Honor - Ubisoft Montreal
Kingdom Come: Deliverance - Warhorse Studios
The Fall Part 2: Unbound - Over The Moon
Crossing Souls - Fourattic
Dynasty Warriors 9 - Omega Force
Eastshade - Eastshade Studios
Tannenberg - Blackmill Games
Crusader Kings II - Paradox Development Studio
Dear Esther - The Chinese Room
'Sid Meier''s Civilization VI: Gathering Storm' - Firaxis Games
The Textorcist: The Story of Ray Bibbia - Morbidware
Hatoful Boyfriend - Hato Moa
ZHEROS - Rimlight Studios
The Wardrobe - C.I.N.I.C. Games
Metro Exodus - 4A Games
Far Cry New Dawn - Ubisoft Montreal
Jump Force - Spike Chunsoft Co. Ltd., Spike Chunsoft
Crackdown 3 - Sumo Digital, Elbow Rocket
Alan Wake - Remedy Entertainment
Pillars of Eternity: The White March - Part 2 - Obsidian Entertainment
Street Fighter V - Capcom
Layers of Fear - Bloober Team
theHunter: Call of the Wild - Expansive Worlds
Realpolitiks - Jujubee S.A.
Fe - Zoink!
Back to the Future: The Game - Episode II: Get Tannen! - Telltale Games
Total War: Attila - Creative Assembly
Hand of Fate - Defiant Development
Morningstar: Descent to Deadrock - Red Herring Labs
Californium - Nova Production
Halo Wars 2 - Creative Assembly
March of the Eagles - Paradox Development Studio
Banished - Shining Rock Software
Devil Daggers - Sorath
Danganronpa: Trigger Happy Havoc - Spike Chunsoft
Dungelot: Shattered Lands - Red Winter Software Limited, Red Winter Software
Cities: Skylines - Snowfall - Colossal Order
Galactic Civilizations III: Mercenaries - Stardock
Crysis 3 - Crytek
Strider - Double Helix Games
Frozen Cortex - Mode 7 Games
The Station - The Station
Devotion - Red Candle Game
Yakuza Kiwami - Ryu ga Gotoku Studios
The Book of Unwritten Tales 2 - KING Art
Age of Empires: Definitive Edition - Microsoft Game Studios
SYMMETRY - Sleepless Clinic
Bulletstorm - Epic Games, People Can Fly
Syndicate (2012) - Starbreeze
Richard & Alice - Denby / Raze
Rambo: The Video Game - Teyon
Night in the Woods - Infinite Fall
Rad Rodgers - Interceptor Entertainment
Fable Fortune - Mediatonic
Metal Gear Survive - Konami
Gray Matter - Wizarbox
Cities in Motion - Colossal Order
Fallout: New Vegas - Dead Money - Obsidian Entertainment
Wargame: European Escalation - Eugen Systems
The Bridge (2013) - Ty Taylor and Mario Castaneda
Total War: Arena - Creative Assembly
Stellaris: Apocalypse - Paradox Development Studio
Anthem - BioWare
'Aaru''s Awakening' - Lumenox ehf
Obliteracers - Space Dust Studios, Varkian Empire
Hitman GO: Definitive Edition - Square Enix Montreal
The Walking Dead: Michonne - Episode 1: In Too Deep - Skybound LLC
Shadows of Adam - Something Classic Games LLC
Sword Art Online: Fatal Bullet - Dimps Corporation
Gemini Rue - Wadjet Eye Games, Joshua Nuernberger
Resident Evil: Revelations 2 - Episode 1: Penal Colony - Capcom
There Came an Echo - Iridium Studios
The Flame in the Flood - The Molasses Flood
Hollow Knight - Team Cherry
911 Operator - Jutsu Games
Men of War: Assault Squad - THQ, 1C, 1C Company
Trapped Dead - Headup Games, Crenetic Studios
Painkiller: Redemption - DreamCatcher Interactive
Thief - Nixxes Software
Castlevania: Lords of Shadow 2 - Mercury Steam
'Oddworld: Abe''s Oddysee - New ''n'' Tasty' - Just Add Water
Homeworld Remastered Collection - Gearbox Software
Republique: Episode 1 - Exordium - Camouflaj, LLC
Grim Dawn - Crate Entertainment
SUPERHOT - SUPERHOT
'Heaven''s Hope' - Mosaic Mask
We Are The Dwarves - Whale Rock Games
Bit.Trip Presents...Runner2: Future Legend of Rhythm Alien - Gaijin Games
Brutal Legend - Double Fine Productions
Stardew Valley - Eric Barone, ConcernedApe
The Town of Light - LKA
DiRT Rally 2.0 - Codemasters
Trials Rising - RedLynx
Star Conflict - Star Gem Inc.
Shadowrun: Dragonfall - Harebrained Schemes LLC
Resident Evil 4: Ultimate HD Edition - Capcom, QLOC
Oblitus - Connor Ullmann
Stories Untold - No Code
Into the Breach - Subset Games
Gravel - Milestone S.r.l
Warhammer 40,000: Dawn of War II - Retribution - Relic
Fate of the World - Red Redemption
Sniper Elite: Nazi Zombie Army - Rebellion
Torment: Tides of Numenera - InXile Entertainment
DESYNC - Foregone
Where the Water Tastes Like Wine - Dim Bulb Games
H1Z1 - Daybreak Games
Ape Out - Gabe Cuzzillo
Microsoft Flight - Microsoft Game Studios
Da New Guys: Day of the Jackass - Wadjet Eye Games
Far Cry Primal - Ubisoft Montreal
Soul Axiom - Wales Interactive Ltd.
Seduce Me - 
Edna & Harvey: The Breakout - Daedalic Entertainment
continue?9876543210 - Jason Oda
Pony Island - Daniel Mullins Games
Milkmaid of the Milky Way - machineboy
The Eternal Castle Remastered - Leonard Menchiari
Kentucky Route Zero - Act I - Cardboard Computer
Secrets of Raetikon - Broken Rules
Warhammer Quest - Rodeo Games
CONSORTIUM - Interdimensional Games Inc
Punch Club - Lazy Bear Games
Metal Gear Rising: Revengeance - PlatinumGames
Bury Me, My Love - The Pixel Hunt
Catherine Classic - Atlus
'A Fisherman''s Tale' - Innerspace VR
DC Universe Online - WBIE
Choplifter HD - InXile Entertainment
That Dragon, Cancer - Numinous Games
Tharsis - Choice Provisions
War, the Game - GabberGames
'Assassin''s Creed Chronicles: India' - Climax Group, Climax Studios
Detention - Red Candle Game
Bloodline Champions - Stunlock Studios
Nidhogg - Messhof
The Sims 4: Outdoor Retreat - Maxis
Rise & Shine - Super Mega Team, Super Awesome Hyper Dimensional Mega Team
Darkout - Allgraf
Europa Universalis IV: Conquest of Paradise - Paradox Development Studio
The Banner Saga - Stoic
SpellForce 2: Demons of the Past - Mind over Matter
Avernum 2: Crystal Souls - Spiderweb Software
JumpJet Rex - TreeFortress Games
Oxenfree - Night School Studio
'Borderlands 2: Sir Hammerlock''s Big Game Hunt' - Gearbox Software
'Assassin''s Creed Liberation HD' - Ubisoft Sofia
'Dragon''s Dogma: Dark Arisen' - Capcom, QLOC
Echoes Of Aetheria - Dancing Dragon games
The Walking Dead: The Telltale Series - The Final Season Episode 3: Broken Toys - Telltale Games, Skybound Games
My Time At Portia - Pathea Games
Onimusha: Warlords - Capcom
Euro Truck Simulator 2 - SCS Software
Dustforce - Hitbox 
Divinity: Original Sin - Larian Studios Games Ltd
She Remembered Caterpillars - Ysbryd Games
Full Metal Furies - Cellar Door Games
YIIK: A Postmodern RPG - Ackkstudios
Gemini: Heroes Reborn - Phosphor Games
Nantucket - Picaresque Studio
Genital Jousting - Free Lives
Unstoppable Gorg - Futuremark Games Studio
Darkest Dungeon - Red Hook Studios
The Bug Butcher - Awfully Nice Studios
The Aquatic Adventure of the Last Human - YCJY
The Deadly Tower of Monsters - ACE Team
Blade & Soul - NCSOFT
Resident Evil 0: HD Remaster - Capcom
Shooting Stars! - Bloodirony
Stars in Shadow - Ashdar Games
Warhammer 40,000: Sanctus Reach - Strayllight Entertainment
Sairento VR - Mixed Realms Pte Ltd
KickBeat: Steam Edition - Zen Studios
Resident Evil HD Remaster - Capcom
Blackguards 2 - Daedalic Entertainment
Saints Row: Gat Out of Hell - Volition Inc.
Citizens of Earth - Eden Industries
Homeworld: Deserts of Kharak - Blackbird Interactive
Urban Empire - Fragment Production Ltd, Reborn Games Inc.
Crashlands - Butterscotch Shenanigans
The Westport Independent - Double Zero One Zero
Dinocide - AtomicTorch
Between Me and The Night - RainDance LX
The Red Strings Club - Deconstructeam
Batman: The Enemy Within - Episode 4: What Ails You - Telltale Games
The Hong Kong Massacre - VRESKI
Atom Zombie Smasher - Blendo Games
The Cave (2013) - Double Fine Productions
Strike Suit Zero - Born Ready Games
Might & Magic X: Legacy - Limbic Entertainment
Grey Goo - Petroglyph
Phantom Breaker: Battle Grounds - Mages.
Resident Evil 7: biohazard - Capcom
Subnautica - Unknown Worlds Entertainment
Iconoclasts - Joakim Sandberg, Konjak
Total War: WARHAMMER II - Rise of the Tomb Kings - Creative Assembly
Lost Sphear - Tokyo RPG Factory
Slay the Spire - Mega Crit Games
Unruly Heroes - Magic Design Studios
'Jon Shafer''s At the Gates' - Conifer Games
Monday Night Combat - Uber Entertainment
Law & Order: Legacies - Telltale Games
DmC: Devil May Cry - Ninja Theory, QLOC
Ace Combat Assault Horizon: Enhanced Edition - Project Aces , QLOC
Akaneiro: Demon Hunters - Spicy Horse
LEGRAND LEGACY: Tale of the Fatebounds - SEMISOFT
Life is Strange 2: Episode 2 - Rules - DONTNOD Entertainment
Battlefleet Gothic: Armada 2 - Tindalos Interactive
Pikuniku - Sectordub
Dead Space 2 - Visceral Games
Magicka - Arrowhead Game Studios
Venetica - Deck 13
SOL: Exodus - Seamless Entertainment, Inc.
Path of Exile - Grinding Gear Games
Memoranda - Bit Byterz
Celeste - Matt Makes Games Inc.
Resident Evil 2 - Capcom R&D Division 1
Breach (2011) - Atomic Games
Grim Fandango Remastered - Double Fine Productions
Gravity Ghost - Ivy Games LLC
The Witness - Thekla, Inc
Hex: Shards of Fate - Cryptozoic Entertainment, Hex Entertainment
Tales of Berseria - Bandai Namco Games
A Normal Lost Phone - Accidental Queens
Dragon Ball FighterZ - Arc System Works
Railway Empire - Gaming Minds Studios
King Arthur II: The Role-Playing Wargame - NeocoreGames
Dying Light - Techland
Crasher - Punchers Impact
Broken Age: Act 1 - Double Fine Productions
Broken Age - Double Fine Productions
Strike Vector - Strike Vector Team, Ragequit Corporation
Rekoil - Plastic Piranha
Fahrenheit: Indigo Prophecy Remastered - Aspyr
Rise of the Tomb Raider - Crystal Dynamics, Nixxes Software
Dungeonland - Critical Studio
Rush Bros - XYLA Entertainment
The Castle Doctrine - Jason Rohrer
Pix the Cat - Pasta Games
Heroes of Might & Magic III - HD Edition - Ubisoft
Supreme League of Patriots - No Bull Intentions
Sebastien Loeb Rally Evo - Milestone S.r.l
Bombshell (2016) - Interceptor Entertainment
Genesis Alpha One - Radiation Blue
Proteus - Ed Key and David Kanaga
Cognition: An Erica Reed Thriller Episode 2 - The Wise Monkey - Phoenix Online Studios
Octodad: Dadliest Catch - Young Horses, Inc
Life is Strange: Episode 1 - Chrysalis - DONTNOD Entertainment
Zombeer - Moonbite Games
'Raven''s Cry' - Reality Pump
Double Dragon IV - Arc System Works
Remothered: Tormented Fathers - Stormind Games
'Mage''s Initiation: Reign of the Elements' - Himalaya Studios
'Who''s That Flying?!' - Mediatonic
Antichamber - Demruth
Retrovirus - Cadenza
Omerta: City of Gangsters - Kalypso
Candleman: The Complete Journey - Spotlightor Interactive
Sunless Skies - Failbetter Games
Ace Combat 7: Skies Unknown - Project Aces 
Sunless Sea - Failbetter Games
Rise of Incarnates - Bandai Namco Games
Horizon - L3O Interactive
'Anna''s Quest' - Krams Design
Legends of Eisenwald - Aterdux Entertainment
Vector Thrust - timesymmetry
The Secret World - Funcom
Mortal Kombat Komplete Edition - NetherRealm Studios
The Walking Dead: 400 Days - Telltale Games
DARK - Kalypso
Red Faction: Guerrilla Re-Mars-tered - Volition Inc.
Endless Space - Amplitude Studios
TrackMania 2 Valley - Nadeo
Black The Fall - Sand Sailor Studio
Rocket League - Psyonix
Furi - The Game Bakers
Kingdom Come: Deliverance - From The Ashes - Warhorse Studios
Super Street Fighter IV: Arcade Edition - Capcom, QLOC
Yatagarasu: Attack on Cataclysm - PDW: Hotapen
INSIDE - PLAYDEAD
'The Lion''s Song' - 'Mi''pu''mi Games'
TRI - Rat King Entertainment
'Sid Meier''s Civilization V: Brave New World' - Firaxis Games
Dusty Revenge - PD Design Studio Pte Ltd
The Wolf Among Us: Episode 5 - Cry Wolf - Telltale Games
MouseCraft - Crunching Koalas
Dota 2 - Valve Software
Whispering Willows - Night Light Interactive
4PM - Bojan Brbora
The Magic Circle - Questionary, Question
The Red Solstice - Ironward
F1 2015 - Codemasters
Traverser - Gatling Goat Studios
The Lost Chronicles of Zerzura - Cranberry Production
Quest for Infamy - Infamous Quests
Antihero - Tim Conkling
Panzer Corps - The Lordz Games Studio
Anna - Dreampainters
Toki Tori 2 + - Two Tribes
Bit.Trip Fate - Gaijin Games
Humans Must Answer - SumomGames
Minecraft: Story Mode Season Two - Episode 1: Hero in Residence - Telltale Games
Harry Potter and the Deathly Hallows, Part 2 - 
VIDEOBALL - Action Button Entertainment
Anarcute - Anarteam
Poly Bridge - Dry Cactus
Song of the Deep - Insomniac Games
Necropolis - Harebrained Schemes LLC
The End Is Nigh - Edmund McMillen, Tyler Glaiel 
Warhammer 40,000: Gladius - Relics of War - Proxy Studios
Seeking Dawn - Multiverse Games, Multiverse
Earthfall - Holospark
Dungeons of Dredmor - Gaslamp Games
La-Mulana (Remake) - Nigoro
Dream - HyperSloth
Crush Your Enemies - Vile Monarch
The Spectrum Retreat - Dan Smith Studios
Infinity Runner - Wales Interactive Ltd.
LIGHT - Just A Pixel
AR-K Episode 3: The Great Escape - Gato Salvaje Studio
Guild of Dungeoneering - Gambrinous
Abyss Odyssey - ACE Team
Wayward Manor - Moonshark
Metro: Last Light - Faction Pack - 4A Games
R.I.P.D. The Game - Old School Games
Magic: Duels of the Planeswalkers 2015 - Wizards of the Coast
Luckslinger - Duckbridge
Sorcerer King - Stardock
Legions of Steel - Slitherine, Slitherine Group
So Many Me - Extend Interactive
Darkwood - Acid Wizard Studio
Albion Online - Sandbox Interactive
Yonder: The Cloud Catcher Chronicles - Prideful Sloth
Serial Cleaner - iFun4all
Archangel: Hellfire - Skydance Interactive
Mothergunship - Grip Digital
Far Cry 5: Lost on Mars - Ubisoft Montreal
Halo: Spartan Assault - Vanguard, 343 Industries
Face Noir - Mad Orange
Children of Zodiarcs - Cardboard Utopia
Fallout: New Vegas - Old World Blues - Obsidian Entertainment
Supreme Ruler: Cold War - BattleGoat Studios
Chime Sharp - Twistplay, Ste Curran
I Am Setsuna - Tokyo RPG Factory
The Assembly - nDreams
Aporia: Beyond The Valley - Investigate North
Runespell: Overture - Mystic Box
7554 - Emobi Games
Breach & Clear: Deadline - Mighty Rabbit Studios
Kentucky Route Zero - Act IV - Cardboard Computer
Zombie Night Terror - NoClip
Lone Echo - Ready at Dawn
Gigantic - Motiga
Dream Daddy: A Dad Dating Simulator - Game Grumps
Kingdoms and Castles - Lion Shield, LLC
The Asskickers - AGO Games
Freedom Planet - GalaxyTrail
Game of Thrones: Episode Five - A Nest of Vipers - Telltale Games
Tembo the Badass Elephant - Game Freak
Kelvin and the Infamous Machine - Blyts
Shattered Skies - Free Reign Entertainment
Bohemian Killing - The Moonwalls
Mercenary Kings - Tribute Games, Tribute Games Inc.
Dark Souls II: Crown of the Sunken King - Namco Bandai Games
OlliOlli - Tom Hegarty
The Walking Dead: Season Two Episode 4 - Amid the Ruins - Telltale Games
Hearthstone: Heroes of Warcraft - Curse of Naxxramas - Blizzard Entertainment
Halfway - Robotality
Starbound - Chucklefish
Human: Fall Flat - No Brakes Games
The Raven: Legacy of a Master Thief - KING Art
Unrest - Pyrodactyl Games
Zenzizenzic - Ruud Koorevaar
The Talos Principle: Road To Gehenna - Croteam
Blues and Bullets - Episode 1: The End of Peace - A Crowd of Monsters
Way of the Samurai 4 - Acquire
Feist - Bits & Beasts
Prototype 2 - Radical Entertainment
Teleglitch: Die More Edition - Johamm Tael & Mihkel Tael
NASCAR: The Game 2013 - Eutechnyx
Gods Will Be Watching - Devolver Digital
Victor Vran - Haemimont Games
Cradle - Flying Cafe for Semianimals
Semblance - Nyamakop
The Council - Episode 3: Ripples - Big Bad Wolf
Shadowrun Returns - Harebrained Schemes LLC
Quadrilateral Cowboy - Blendo Games
Pyre - Supergiant Games
Fortnite - Epic Games
Aven Colony - Mothership Entertainment
Ys: Memories of Celceta - Falcom
Dragon Age II: Legacy - BioWare
Headlander - Double Fine Productions
Solstice Chronicles: MIA - Ironward
The Banner Saga 3 - Stoic
MARVEL Powers United VR - Sanzaru Games
Dead Horde - DNS Development
Legend of Kay Anniversary - Neon Studios, Kaiko
The Darkside Detective - Spooky Doorway
'King''s Quest Chapter 1: A Knight to Remember' - The Odd Gentlemen
Life is Strange: Episode 4 - Dark Room - DONTNOD Entertainment
The Swindle - Size Five Games
Kyn - Tangrin
Day of Infamy - New World Interactive
Total War: WARHAMMER - Call of the Beastmen - Creative Assembly
Sundered - Thunder Lotus Games
Chantelise: A Tale of Two Sisters - EasyGameStation
E.Y.E: Divine Cybermancy - Streum On Studio
CastleStorm - Zen Studios
Firefall - Red 5 Studios
Magic Duels: Origins - Stainless Games
Orcs Must Die! 2 - Robot Entertainment
La-Mulana 2 - Nigoro
Chasm - Discord Games
The Political Machine 2012 - Stardock
Rise of the Triad - Interceptor
Sacred 3 - Deep Silver
Enki - Storm in a Teacup
This is the Police 2 - Weappy Studio
Home - Benjamin Rivers
Massive Chalice - Double Fine Productions
Dirty Bomb - Splash Damage
Hatred - Destructive Creations
Senran Kagura Shinovi Versus - Tamsoft, Marvelous AQL
TurnOn - Brainy Studio LLC
Tekken 7 - Bandai Namco Games
Formula Fusion - R8 Games
Heroes of the Storm - Blizzard Entertainment
Brigador - Stellar Jockeys
Dangerous Golf - Three Fields Entertainment
Blitzkrieg 3 - Nival Interactive, Nival
Gunpoint - Tom Francis
Remember Me - DONTNOD Entertainment
Marvel Heroes - Gazillion
WildStar - Carbine Studios
Murdered: Soul Suspect - Airtight Games
Hard Reset Redux - Flying Wild Hog
Marvel Heroes 2015 - Gazillion
Star Hammer: The Vanguard Prophecy - Black Lab Games
The Masterplan - Shark Punch
Vampyr - DONTNOD Entertainment
Prime World: Defenders - Nival Interactive
Nether - Phosphor Games Studio, LLC
'D4: Dark Dreams Don''t Die' - Access Games
Far Cry 5: Hours of Darkness - Ubisoft Montreal
Warhammer 40,000: Inquisitor - Martyr - NeocoreGames
Red Faction: Armageddon - Volition Inc.
Operation Flashpoint: Red River - Codemasters
Concursion - Puuba
Hearts of Iron IV - Paradox Development Studio
Edge of Nowhere - Insomniac Games
'Marvel''s Guardians of the Galaxy - Episode 2: Under Pressure' - Telltale Games
Conarium - Zoetrope Interactive
Antigraviator - Iceberg Interactive
Pride of Nations - Paradox Interactive, AGEOD
SteamWorld Heist - Image & Form
Ghost 1.0 - @unepic_fran
'Mirror''s Edge Catalyst' - EA DICE
The Solus Project - Grip Games
Gray Dawn - Interactive Stone
Jamestown: Legend of the Lost Colony - Final Form Games, LLC
Gemini Wars - Camel 101
DiRT 4 - Codemasters
Kholat - IMGN.PRO
Unravel Two - Coldwood Interactive
Storm: Frontline Nation - SimBin
The Mighty Quest for Epic Loot - Ubisoft Montreal
Munin - Gojira
Enemy Front - CI Games
'Sherlock Holmes: The Devil''s Daughter' - Frogwares
Prey: Mooncrash - Arkane Studios
LEGO Jurassic World - TT Games
Alone in the Dark: Illumination - Pure FPS
Jurassic World Evolution - Frontier Developments
Sins of a Solar Empire: Rebellion - Ironclad Games
Krater - Fatshark AB
SpinTires - Oovee Game Studios
Lust for Darkness - Movie Games
Duke Nukem Forever - Gearbox Software, 3D Realms
Planetary Annihilation - Uber Entertainment
The Incredible Adventures of Van Helsing II - NeocoreGames
Shadows: Heretic Kingdoms - Games Farm
Space Run - Passtech Games
On Rusty Trails - Black Pants Studio
Trials of the Blood Dragon - RedLynx
Bus Simulator 18 - stillalive studios
Alice: Madness Returns - Spicy Horse
The Yawhg - damiansommer
Dead by Daylight - Behaviour Interactive
Wreckfest - Bugbear
Magic: The Gathering - Duels of the Planeswalkers 2012 - Stainless Games
Pro Cycling Manager 2017 - Cyanide
Solar 2 - Murudai
Space Run Galaxy - Passtech Games
Dreamfall Chapters - Red Thread Games
'Sid Meier''s Civilization V: Gods & Kings' - Firaxis Games
Dungeons & Dragons: Chronicles of Mystara - Iron Galaxy Studios
Knights of Pen & Paper +1 Edition - Behold Studios
Pro Cycling Manager Season 2015 - Cyanide
Space Pirates and Zombies - MinMax Games Ltd.
Resonance - xii games
'Tiny & Big: Grandpa''s Leftovers' - Black Pants
SpellForce 2: Faith in Destiny - JoWooD Entertainment AG
Pro Cycling Manager Season 2014: Le Tour de France - Cyanide
Darkest Dungeon: The Crimson Court - Red Hook Studios
Dungeon Siege III - Obsidian Entertainment
Magic: The Gathering - Duels of the Planeswalkers 2013 - Stainless Games
Neverwinter - Cryptic Studios
Magrunner: Dark Pulse - Frogwares
Pro Cycling Manager Season 2013: Le Tour de France - 100th Edition - Cyanide
Final Fantasy XIV: Stormblood - Square Enix
Nex Machina: Death Machine - Housemarque
'Serious Sam''s Bogus Detour' - Crackshell
Get Even - The Farm 51
'The Mage''s Tale' - InXile Entertainment
F.E.A.R. 3 - Day 1 Studios
Gods & Heroes: Rome Rising - Heatwave Interactive
Quantum Conundrum - Airtight Games
Fist Puncher - Team2Bit
Hexodius - Brain Slap Studio
VA-11 Hall-A: Cyberpunk Bartender Action - Sukeban Games
Mighty No. 9 - Inti Creates
Umbrella Corps - Capcom
Master X Master - NCSOFT
The Dark Eye: Chains of Satinav - Daedalic Entertainment
Pro Cycling Manager Season 2012: Le Tour de France - Cyanide
Breached - Drama Drifters
The Sims 4: Seasons - Maxis
Back to the Future: The Game - Episode V: OUTATIME - Telltale Games
Company of Heroes 2: The Western Front Armies - Relic, Relic Entertainment
Final Fantasy XIV: Heavensward - Square Enix
Tales From The Borderlands: Episode 3 - Catch A Ride - Telltale Games
Devil May Cry 4: Special Edition - Capcom
Batman: Arkham Knight - Rocksteady Studios, Iron Galaxy Studios
Alpha Polaris: A Horror Adventure Game - Turmoil Games
Deadpool - High Moon Studios
Ride to Hell: Retribution - Eutechnyx, Deep Silver
Plants vs Zombies: Garden Warfare - PopCap
Transformers: Rise of the Dark Spark - Edge of Reality
Her Story - Sam Barlow
Penny Arcade Adventures: Episode Three - Zeboyd Games
Spec Ops: The Line - Yager
Company of Heroes 2 - Relic
The Sims 3: Island Paradise - The Sims Studio
Valiant Hearts: The Great War - Ubisoft Montpellier
The Awesome Adventures of Captain Spirit - DONTNOD Entertainment
Battlefield 3: Close Quarters - EA DICE
'Tom Clancy''s Ghost Recon: Future Soldier' - Ubisoft Paris
Magic: Duels of the Planeswalkers 2014 - Stainless Games
Shovel Knight - Yacht Club Games
GRID Autosport - Codemasters
Secret World Legends - Funcom
Rogue Legacy - Cellar Door Games
Leisure Suit Larry: Reloaded - Replay Games
Sniper Elite III - Rebellion
LEGO Star Wars: The Force Awakens - TT Games
Diablo III: Rise of the Necromancer - Blizzard Entertainment
Youropa - frecle ApS
Hoodwink - E-One Studio
Jack Keane 2: The Fire Within - Deck 13
The Technomancer - Spidersoft, Spiders
The Crew 2 - Ubisoft Ivory Tower
The Walking Dead: Episode 2 - Starved for Help - Telltale Games
Zero Escape: Zero Time Dilemma - Spike Chunsoft
Micro Machines World Series - Codemasters
Crash Bandicoot N. Sane Trilogy - Vicarious Visions
Puzzle Agent 2 - Telltale Games
Thomas Was Alone - Mike Bithell
Cognition: An Erica Reed Thriller Episode 3 - The Oracle - Phoenix Online Studios
RONIN - Tomasz Waclawek
Rift - Trion Worlds
Vessel - Strange Loop Games
Insurgency - New World Interactive
Deponia Doomsday - Daedalic Entertainment
Gears of War: Ultimate Edition for Windows 10 - Epic Games, Splash Damage, The Coalition
Robo Recall - Epic Games
Apocalipsis - Punch Punk Games
Dead or Alive 6 - Team Ninja, Koei Tecmo Games
Dawn of Man - Madruga Works
SpaceChem - Zachtronics Industries
'Five Nights at Freddy''s 3' - Scott Cawthon
BlazBlue: Chrono Phantasma Extend - Arc System Works
Bus Simulator 16 - Still Alive Studios
Guns, Gore & Cannoli 2 - Crazy Monkey Studios
Pit People - The Behemoth
White Night - OSome Studio
The Count Lucanor - Baroque Decay
Black Desert Online - Pearl Abyss
E.T. Armies - Raspina Studio
Tomb Raider - Crystal Dynamics, Nixxes Software
South Park: The Stick of Truth - Obsidian Entertainment
The Walking Dead: Season Two Episode 2 - A House Divided - Telltale Games
Tower of Guns - Terrible Posture Games
Tormentum - Dark Sorrow - OhNoo
Into the Stars - Fugitive Games
Mass Effect 3: Citadel - BioWare
Arma 3 - Bohemia Interactive
The Sims 3: University Life - The Sims Studio
The Showdown Effect - Arrowhead Game Studios
SimCity - Maxis
10 Second Ninja - GameDesignDan
The Occupation - White Paper Games
Mass Effect 3 - BioWare
Stacking - Double Fine Productions
The Sims 3: Showtime - The Sims Studio
Year Walk - Simogo
Infested Planet - Rocket Bear Games
Lifeless Planet - Stage 2 Studios
Zombie Army Trilogy - Rebellion
'Tom Clancy''s Ghost Recon: Wildlands' - Ubisoft Paris
Final Fantasy XV: Windows Edition - Square Enix
Fear Effect Sedna - Sushee
Super Seducer: How to Talk to Girls - RLR Training Inc
LEGO Worlds - TT Games
Loot Rascals - Hollow Ponds
CHUCHEL - Amanita Design
Devil May Cry 5 - Capcom
Dragon Age II - BioWare
'Tom Clancy''s The Division' - Massive Entertainment
Shardlight - Wadjet Eye Games
Faeria - Abrakam SA
Warhammer: Vermintide 2 - Fatshark AB, Fatshark
'Assassin''s Creed Rogue' - Ubisoft
Shelter 2 - Might and Delight
Battlefield: Play4Free - Digital Illusions
Cities: Skylines - Colossal Order
Hotline Miami 2: Wrong Number - Dennaton
DeathSmiles - Cave
Kona - Parabole
The Guest - Team Gotham
Moon Hunters - Kitfox Games
2Dark - Gloomywood
Battle: Los Angeles - Saber Interactive
Sniper: Ghost Warrior 2 - City Interactive
Hearthstone: Heroes of Warcraft - Blizzard Entertainment
TowerFall Ascension - Matt Thorson
Titanfall - Respawn Entertainment
1954: Alcatraz - Daedalic Entertainment
Windforge - Snowed In Studios
Ori and the Blind Forest - Moon Studios
Hitman - Intro Pack - Io Interactive
Gremlins, Inc. - Yukitama Creative Industries
'Alekhine''s Gun' - Maximum Games
Starcraft II: Heart of the Swarm - Blizzard Entertainment
Dreamfall Chapters Book Two: Rebels - Red Thread Games
'Sid Meier''s Starships' - Firaxis Games
Hypnospace Outlaw - Tendershoot
Truberbrook: A Nerd Saves the World - btf GmbH, btf
Warp - Trapdoor
LA Cops - Modern Dream
Q.U.B.E. 2 - Toxic Games
Kerbal Space Program: Making History - Squad
Ghost of a Tale - Ghost of a Tale, SeithCG
The Council - Episode 1: The Mad Ones - Big Bad Wolf
Pure Farming 2018 - Ice Flames
Homefront - Digital Extremes
Defenders of Ardania - Most Wanted Entertainment
Battlefield 1: They Shall Not Pass - EA DICE
Styx: Shards of Darkness - Cyanide
Total War: Shogun 2 - Creative Assembly
Need for Speed - Ghost Games
Sheltered - Unicube
Future Unfolding - Spaces of Play
Surviving Mars - Haemimont Games
'Tom Clancy''s The Division 2' - Massive Entertainment
Deus Ex: The Fall - Square Enix
Tales From The Borderlands: Episode 2 - Atlas Mugged - Telltale Games
Oceanhorn: Monster of Uncharted Seas - Cornfox & Bros.
Adventures of Pip - TicToc Games
Battlefield Hardline - Visceral Games
Obscuritas - Visual Imagination Software, Ravenscourt, VIS Games
NieR: Automata - PlatinumGames
Senran Kagura: Estival Versus - Tamsoft
Luftrausers - Vlambeer
Resident Evil: Revelations 2 - Capcom
Ys: The Oath in Felghana - Falcom
The Walking Dead: Survival Instinct - Terminal Reality
Lichdom: Battlemage - Xaviant Games, Xaviant
Waveform - Eden Industries
Cloudbuilt - Coilworks
Men of War: Assault Squad 2 - 1C, 1C Company
Three Fourths Home - [bracket]games
The Elder Scrolls: Legends - Bethesda Softworks, Dire Wolf Digital
'The Crow''s Eye' - 3D2 Entertainment
Sea of Thieves - Rare Ltd.
Trials Evolution: Gold Edition - RedLynx
Yaiba: Ninja Gaiden Z - Spark Unlimited, comcept
Day of the Tentacle Remastered - Double Fine Productions
Mass Effect: Andromeda - BioWare
We. The Revolution - Polyslash
'Assassin''s Creed: Brotherhood' - Ubisoft Montreal
Crysis 2 - Crytek
The Sims Medieval - The Sims Studio
LEGO Star Wars III: The Clone Wars - 'Traveller''s Tales'
Forsaken World - Perfect World Entertainment
Total War: Shogun 2 - Fall of the Samurai - Creative Assembly
Yesterday - Pendulo Studios
Resident Evil 6 - Capcom, QLOC
Out of the Park Baseball 17 - Out Of The Park Developments
Nelly Cootalot: The Fowl Fleet - Application Systems Heidelberg Software GmbH, Application Systems Heidelberg
Polaris Sector - SoftWarWare
Fallout 4: Automatron - Bethesda Game Studios
Sekiro: Shadows Die Twice - From Software
Ghostbusters: Sanctum of Slime - Behavior Studios
Ni no Kuni II: Revenant Kingdom - Level 5
A Way Out - Hazelight
Ash of Gods: Redemption - AurumDust
Theatre of War 3: Korea - 1C, 1C Company
Escape Goat 2 - MagicalTimeBean
Life is Strange: Episode 2 - Out of Time - DONTNOD Entertainment
Game of Thrones: Episode Three - The Sword in the Darkness - Telltale Games
Dragon Age: Inquisition - Jaws Of Hakkon - BioWare
Samorost 3 - Amanita Design
Trackmania Turbo - Nadeo
The Descendant - Gaming Corps AB
Slain! - Wolf Brew Games
Battle Brothers - Overhype Studios
Vikings: Wolves of Midgard - Games Farm
BioShock Infinite - Irrational Games
Warframe - Digital Extremes
Diablo III: Reaper of Souls - Blizzard Entertainment
SMITE - Hi-Rez Studios
ETHER One - White Paper Games
BioShock Infinite: Burial at Sea - Episode Two - Irrational Games
Dyscourse - Owlchemy Labs
Etherium - Tindalos Interactive
Battlefield 3: End Game - EA DICE
Slender: The Arrival - Blue Isle Studios
Pressure - Chasing Carrots
Pillars of Eternity - Obsidian Entertainment
Ironcast - Dreadbit
Infinite Crisis - Turbine Inc.
Batman: The Enemy Within - Episode 5: Same Stitch - Telltale Games
The Walking Dead: The Telltale Series - The Final Season Episode 4: Take Us Back - Telltale Games, Skybound Games
Generation Zero - Avalanche Studios
Galactic Civilizations III - Stardock
RIDE - Milestone S.r.l
Far Cry 5 - Ubisoft Montreal
TT Isle of Man - Kylotonn
Back to the Future: The Game - Episode III: Citizen Brown - Telltale Games
Dungeon Hearts - Cube Roots
Tactical Intervention - FIX Korea, Co. LTD
Platformines - Magiko Gaming
Chronos - Gunfire Games
'Lucky''s Tale' - Playful Corp.
ADR1FT - Three One Zero
NightCry - 
Dark Souls III: The Ringed City - From Software
The Walking Dead: The Telltale Series - A New Frontier Episode 3: Above the Law - Telltale Games
Narcosis - Narcosis Team, Honor Code, Inc.
Snake Pass - Sumo Digital
Rain World - Videocult
Bush Hockey League - V7 Entertainment Inc.
Shift 2: Unleashed - Slightly Mad Studios
Mass Effect 2: Arrival - BioWare
Rayman Origins - UBlart Montpellier
Tropico 4: Modern Times - Haemimont, Haemimont Games
Ridge Racer Unbounded - Bugbear
The Last Door: Season 2 - The Game Kitchen
StarCraft II: Nova Covert Ops - Mission Pack 1 - Blizzard Entertainment
FORCED SHOWDOWN - BetaDwarf
The Walking Dead: Michonne - Episode 2: Give No Shelter - Telltale Games
Empires Apart - DESTINYbit
Tropico 6 - Limbic Entertainment
A Pixel Story - Lamplight Studios
Dead or Alive 5: Last Round - Team Ninja
Bloodsports.TV - Fatshark AB, Fatshark
Leap of Fate - Clever-Plays
Epistory - Typing Chronicles - Fishing Cactus
Thimbleweed Park - Ron Gilbert and Gary Winnick
Beat Cop - Pixel Crow
Age of Wonders III - Triumph Studios
Shadowrun Chronicles: Boston Lockdown - Cliffhanger Productions, Cliffhanger Productions
The Sims 4: Get to Work - Maxis
Son of Nor - stillalive studios
Hyper Light Drifter - Heart Machine
'Baldur''s Gate: Siege of Dragonspear' - Overhaul Games
Ashes of the Singularity - Oxide Games
TERA - Bluehole Studio
Fez - Polytron Corp.
Far Cry 3: Blood Dragon - Ubisoft Montreal
Jet Car Stunts - True Axis
Avadon: The Black Fortress - Spiderweb Software
Might & Magic: Heroes VI - Shades of Darkness - Virtuos
Sir, You Are Being Hunted - Big Robot Ltd
A Total War Saga: Thrones of Britannia - Creative Assembly
Mount & Blade: With Fire & Sword - Taleworlds
Duelyst - Counterplay Games
Battleborn - Gearbox Software
Fragments of Him - Sassybot
The Legend of Heroes: Trails in the Sky the 3rd - Falcom
Section 8: Prejudice - TimeGate Studios
Port Royale 3: Pirates and Merchants - Kalypso
Orion: Dino Horde - Spiral Game Studios
Galactic Civilizations III: Crusade - Stardock
City of Brass - Uppercut Games Pty Ltd
Wolfenstein: The Old Blood - MachineGames
Kathy Rain - Clifftop Games
Prey - Arkane Studios
Fortix 2 - Nemesys
Faery: Legends of Avalon - Spiders
Kentucky Route Zero - Act III - Cardboard Computer
Outlast: Whistleblower - 
Full Bore - Whole Hog Games
Flockers - Team 17
Project CARS - Slightly Mad Studios
Tesla Effect: A Tex Murphy Adventure - Big Finish Games
Warlock: Master of the Arcane - Ino-Co
Age of Mythology: Extended Edition - Ensemble Studios
The Impossible Game - Grip Games
Bound by Flame - Spiders
Pillars of Eternity II: Deadfire - Obsidian Entertainment
Conan Exiles - Funcom
Brink - Splash Damage
Lume - State of Play Games
Hydrophobia Prophecy - Dark Energy Digital
Garshasp: The Monster Slayer - Dead Mage Studio
Stellaris - Paradox Development Studio
NBA Playgrounds - Saber Interactive
STRAFE - Pixel Titans
TASTEE: Lethal Tactics - SkyBox Labs
Rakuen - Laura Shigihara
Wild West Online - 
Street Fighter X Tekken - Capcom, QLOC
Kero Blaster - Studio Pixel
Action Henk - RageSquid
Inside My Radio - Seaven Studio
Toren - Swordtales
The First Templar - Haemimont, Haemimont Games
The Last Tinker: City of Colors - Mimimi Productions
Chronology - osao games
Invisible, Inc. - Klei Entertainment
Lemma - Evan Todd
Windward - Tasharen Entertainment
Final Fantasy X / X-2 HD Remaster - Square Enix
Goliath - Whalebox Studio
OVIVO - IzHard
Metro: Last Light - 4A Games
'The Walking Dead: Season Two Episode 3 - In Harm''s Way' - Telltale Games
Memento Mori 2 - 
DOOM - id Software
Megabyte Punch - Reptile
Axiom Verge - Tom Happ
Not a Hero - roll7
Diablo III - Blizzard Entertainment
Game of Thrones - Cyanide, Cyanide Studios
Anomaly 2 - 11 bit studios
Sanctum 2 - Coffee Stain Studios
Loadout - Edge of Reality
Thunder Wolves - Most Wanted Entertainment
BattleBlock Theater - The Behemoth
Heavy Bullets - Terri Vellimann
DreadOut - Digital Happiness
Jagged Alliance: Flashback - Full Control ApS, Full Control
Forgotton Anne - Throughline Games
Horizon Chase Turbo - Aquiris Game Studio
Omensight - Spearhead Games
The Council - Episode 2: Hide and Seek - Big Bad Wolf
Terraria - Re-Logic
Reus - Abbey Games
'King''s Bounty: Dark Side' - 1C-Softclub
The Surge - Deck 13
Empathy - Pixel Night
The Witcher 2: Assassins of Kings - CD Projekt Red Studio
Fable III - Lionhead Studios
Fallout: New Vegas - Honest Hearts - Obsidian Entertainment
Gratuitous Tank Battles - Positech Games
Bad Bots - Point 5 Projects 
Woolfe - The Red Hood Diaries - GriN Multimedia
Homefront: The Revolution - Deep Silver Dambuster Studios
Shadwen - Frozenbyte, Inc.
'Old Man''s Journey' - Broken Rules
FAR: Lone Sails - Okomotive
FOX n FORESTS - Bonus Level Entertainment
The Journey Down: Chapter One - SkyGoblin
Gas Guzzlers: Combat Carnage - Gamepires
Resident Evil: Operation Raccoon City - Slant Six
The Witcher 3: Wild Hunt - CD Projekt Red Studio
Duskers - Misfits Attic
Mages of Mystralia - Borealys Games
Regalia: Of Men and Monarchs - Pixelated Milk
Reservoir Dogs: Bloody Days - Big Star Games
Inner Chains - Telepaths Tree
Wolfenstein: The New Order - MachineGames
Life is Strange: Episode 3 - Chaos Theory - DONTNOD Entertainment
Fallout 4: Far Harbor - Bethesda Game Studios
Koihime Enbu - UNKNOWN GAMES
The Way - Puzzling Dream
Time Machine VR - Minority Media Inc.
Endless Space 2 - Amplitude Studios
Skylar & Plux: Adventure on Clover Island - Right Nice Games
Resident Evil: Revelations - Capcom
Transistor - Supergiant Games
The Last Door - The Game Kitchen
NEON STRUCT - Minor Key Games
POSTAL Redux - Running With Scissors
Always Sometimes Monsters - Vagabond Dog
Technobabylon - Technocrat
Sunset - Tale of Tales
Carmageddon: Reincarnation - Stainless Games
The Elder Scrolls Online: Summerset - ZeniMax Media
'Alan Wake''s American Nightmare' - Remedy Entertainment
Fallen Enchantress: Legendary Heroes - Stardock
Call of Juarez: Gunslinger - Techland
The Incredible Adventures of Van Helsing - NeocoreGames
The Incredible Adventures of Van Helsing III - NeocoreGames
The Elder Scrolls Online: Morrowind - ZeniMax Media
Impact Winter - Mojo Bones
Ancestors Legacy - Destructive Creations
Quarantine Circular - Mike Bithell
State of Decay 2 - Undead Labs
DiRT 3 - Codemasters
DiRT Showdown - Codemasters
Tropico 5 - Haemimont, Haemimont Games
Killer Is Dead: Nightmare Edition - Grasshopper Manufacture
Overwatch - Blizzard Entertainment
Steel Division: Normandy 44 - Eugen Systems
Mirage: Arcane Warfare - Torn Banner Studios
Starpoint Gemini Warlords - Little Green Men
The Fidelio Incident - Act 3 Games, LLC
Dark Souls Remastered - From Software
LEGO Pirates of the Caribbean: The Video Game - 'Traveller''s Tales'
Dust: An Elysian Tail - Humble Hearts
Element4l - i-illusions
Total War: WARHAMMER - Creative Assembly
Lumo - Triple Eh? Ltd
Unforeseen Incidents - Backwoods Entertainment
Bloodstained: Curse of the Moon - Inti Creates
Dungeons & Dragons: Daggerdale - Bedlam Games
Iron Front: Liberation 1944 - X1 Software
MISSING: An Interactive Thriller - Episode One - ZANDEL MEDIA
Vanquish - PlatinumGames
Frozen Synapse - Mode 7 Games
Watch Dogs - Ubisoft Montreal
Game of Thrones: Episode Four - Sons of Winter - Telltale Games
Audiosurf 2 - BestGameEver.com
Magicka 2 - Pieces Interactive
Magnetic: Cage Closed - Guru Games
EVERSPACE - ROCKFISH Games
RiME - Tequila Works, QLOC
Friday the 13th: The Game - IllFonic, Gun Media
GRID 2 - Codemasters
'The Wolf Among Us: Episode 4 - In Sheep''s Clothing' - Telltale Games
Magicka: Wizard Wars - Paradox North
Crusader Kings II: The Old Gods - Paradox Development Studio
The Night of the Rabbit - Daedalic Entertainment
A Story About My Uncle - Gone North Games
Monochroma - Nowhere Studios
0RBITALIS - Alan Zucconi
Homesick - Lucky Pause
Subject 13 - Paul Cuisset
Wargame: AirLand Battle - Eugen Systems
Europa Universalis IV: Wealth of Nations - Paradox Development Studio
Anomaly Defenders - 11 bit studios
Among the Sleep - Krillbite Studio
'Yoku''s Island Express' - Villa Gorilla
Moonlighter - 11 bit studios, Digital Sun
Agony - Madmind Studio
'Hunted: The Demon''s Forge' - InXile Entertainment
The Swapper - Facepalm Games
Rising Storm - Antimatter Games
Expeditions: Conquistador - Logic Artists
Astebreed - Edelweiss
The Fall - Over The Moon
The Witcher 3: Wild Hunt - Blood and Wine - CD Projekt Red Studio
Planar Conquest - Wastelands Interactive
Rising Storm 2: Vietnam - Antimatter Games
Star Trek: Bridge Crew - Ubisoft, Red Storm Entertainment
The Walking Dead: The Telltale Series - A New Frontier Episode 5: From The Gallows - Telltale Games
The Long Journey Home - Daedalic Studio West
Perception - The Deep End Games
'Hamilton''s Great Adventure' - Fatshark AB
The Sims 3: Generations - The Sims Studio
Max Payne 3 - Rockstar Games, Rockstar Studios
Ys Origin - Falcom
Kentucky Route Zero - Act II - Cardboard Computer
Hitman - Episode 3: Marrakesh - Io Interactive
Demetrios - The BIG Cynical Adventure - COWCAT
Dead Island: Definitive Collection - Techland
Tokyo 42 - SMAC Games
Overload - Revival Productions, LLC
Cultist Simulator - Weather Factory
Smoke and Sacrifice - Solar Sail Games
To the Moon - Freebird Games
The Lord of the Rings: War in the North - Snowblind Studios
Football Manager 2013 - Sports Interactive
Cargo Commander - Serious Brew
Lilly Looking Through - Geeta Games
Owlboy - D-Pad Studio
The Sims 4: City Living - Maxis
Paper Sorcerer - Ultra Runaway Games
Anno 2205 - Blue Byte
Call of Duty: WWII - Sledgehammer Games
Football Manager 2019 - Sports Interactive
Sonic Generations - Sega
Call of Duty: Advanced Warfare - Sledgehammer Games
Depth - Digital Confectioners
Xanadu Next - Falcom
Call of Duty: Infinite Warfare - Infinity Ward
.hack//G.U. Last Recode - CyberConnect2
Xenonauts - Gamethunks, Goldhawk Interactive
Battle Worlds: Kronos - KING Art
Call of Duty: Ghosts - Infinity Ward
Journey of a Roach - Koboldgames
The Binding of Isaac: Rebirth - Nicalis
Football Manager 2017 - Sports Interactive
State of Decay - Undead Labs
Call of Duty: Black Ops III - Treyarch
Clandestine - Logic Artists
Chaos on Deponia - Daedalic Entertainment
Blackguards - Daedalic Entertainment
The Incredible Adventures of Van Helsing: Final Cut - NeocoreGames
The Fall of the Dungeon Guardians - Mana Games
GRIP: Combat Racing - Caged Element Inc.
'OVERKILL''s The Walking Dead' - Starbreeze
Football Manager 2015 - Sports Interactive
A Bird Story - Freebird Games
Nioh: Complete Edition - Team Ninja
Hand of Fate 2 - Defiant Development
'Marvel''s Guardians of the Galaxy - Episode 5: Don''t Stop Believin''' - Telltale Games
Sonic Forces - Sonic Team
'Leisure Suit Larry: Wet Dreams Don''t Dry' - CrazyBunch
Steel Rats - Tate Multimedia
TSIOQUE - OhNoo
KURSK - Jujubee
L.A. Noire: The Complete Edition - Rockstar Leeds
Call of Duty: Modern Warfare 3 - Infinity Ward, Sledgehammer Games
Risk of Rain - Chucklefish, Hopoo Games
Transport Fever - Urban Games
Small Radios Big Televisions - Owen Deery, Fire Face
Battlerite - Stunlock Studios
Total War: WARHAMMER II - Curse of the Vampire Coast - Creative Assembly
11-11: Memories Retold - Digixart Entertainment
'FLY''N' - Ankama
Fallout 4 - Bethesda Game Studios
Motorsport Manager - Playsport Games, Playsport Games Ltd
Beholder - Warm Lamp Games
Thronebreaker: The Witcher Tales - CD Projekt Red Studio
The Elder Scrolls V: Skyrim - Bethesda Game Studios
Starcraft II: Legacy of the Void - Blizzard Entertainment
Dishonored 2 - Arkane Studios
Tyranny - Obsidian Entertainment
Yesterday Origins - Pendulo Studios
Senran Kagura: Bon Appetit! - Full Course - Meteorise
Football Manager 2018 - Sports Interactive
The Sims 4: Cats & Dogs - Maxis
Need for Speed Payback - Electronic Arts
XCOM: Enemy Within - Firaxis Games
PixelJunk Shooter - Q-Games
Valkyria Chronicles - Sega
'Assassin''s Creed Unity' - Ubisoft, Ubisoft Montreal
Toybox Turbos - Codemasters
Candle - Teku Studios 
Call of Duty: Black Ops II - Treyarch
Pro Evolution Soccer 2014 - Konami
BioShock Infinite: Burial at Sea - Episode One - Irrational Games
SimCity: Cities of Tomorrow Expansion Pack - Maxis
Space Hulk Ascension - Full Control ApS, Full Control
'Randal''s Monday' - Nexus Game Studio
Rift: Storm Legion - Trion Worlds
The Sims 3 Seasons - The Sims Studio
F1 Race Stars - Codemasters
World of Warplanes - Wargaming.net
Redshirt - The Tiniest Shark
World of Warcraft: Warlords of Draenor - Blizzard Entertainment
Pro Evolution Soccer 2015 - Konami
Football Manager 2016 - Sega
Hitman 2 - Io Interactive
Saints Row: The Third - Volition Inc.
Pandora: First Contact - Proxy Studios
This War of Mine - 11 bit studios
Lords of Xulima - Numantian Games
Outcast: Second Contact - Bigben Interactive, Bigben Games
Fallout 76 - Bethesda Game Studios
Unity of Command - 2x2 Games
Rochard - Recoil Games
Need for Speed: The Run - Black Box
Jurassic Park: The Game - Telltale Games
'Baldur''s Gate II: Enhanced Edition' - Overhaul Games
Contrast - Compulsion Games
Deadfall Adventures - The Farm 51
X Rebirth - Egosoft
Silence: The Whispered World 2 - Daedalic Entertainment
Battlefield V - EA DICE
Warhammer 40,000: Mechanicus - Bulwark Studios
Underworld Ascendant - OtherSide Entertainment
RollerCoaster Tycoon World - Nvizzio Creations
Tower 57 - Pixwerk
The Sims 4: Get Famous - Electronic Arts
Anno 2070 - Blue Byte, Related Designs
Company of Heroes 2: Ardennes Assault - Relic, Sega, Relic Entertainment
Far Cry 4 - Ubisoft Montreal
Star Wars Battlefront - EA DICE
Game of Thrones: Episode Six - The Ice Dragon - Telltale Games
Game of Thrones: A Telltale Games Series - Telltale Games
Life is Feudal: Your Own - Bitbox Ltd.
Planet Coaster - Frontier Developments
ICEY - Shanghai FantaBlade Network Technology Co., Ltd.
EVE: Valkyrie - CCP
Titan Quest: Ragnarok - Iron Lore Entertainment
Star Wars Battlefront II - EA DICE
Crusader Kings II: Sons of Abraham - Paradox Development Studio
Dragon Age: Inquisition - BioWare
Never Alone - Upper One Games
Rollers of the Realm - Phantom Compass
Escape Dead Island - Fatshark AB
Hard West - CreativeForge Games
Killing Floor 2 - Tripwire Interactive
Steep - Ubisoft Annecy
Hitman: Absolution - Io Interactive, Nixxes Software
Scribblenauts Unlimited - 5TH Cell
Little Inferno - Tomorrow Corporation
'Assassin''s Creed IV: Black Flag' - Ubisoft
Need for Speed: Rivals - Ghost Games
'Assassin''s Creed Syndicate' - Ubisoft Quebec
Mordheim: City of the Damned - Rogue Factor
Farming Simulator 19 - Giants Software
PlanetSide 2 - Sony Online Entertainment
'Borderlands 2: Mr. Torgue''s Campaign of Carnage' - Gearbox Software
'Assassin''s Creed III' - Ubisoft
The Marvellous Miss Take - Wonderstruck Games
Thea: The Awakening - MuHa Games
Mayan Death Robots - Sileni Studios
Batman: Arkham City - Rocksteady Studios
Grotesque Tactics 2: Dungeons & Donuts - Silent Dreams
The Walking Dead: Episode 5 - No Time Left - Telltale Games
World of Final Fantasy - Square Enix
Batman: The Enemy Within - Episode 3: The Fractured Mask - Telltale Games
TARTARUS - Abyss Gameworks
Serious Sam 3: BFE - Croteam
Batman: The Telltale Series - Episode 4: Guardian of Gotham - Telltale Games
Minecraft: Story Mode - Episode 3: The Last Place You Look - Telltale Games
Afterfall: InSanity - Nicolas Intoxicate
Tales From The Borderlands: Episode 1 - Zer0 Sum - Telltale Games
Geometry Wars 3: Dimensions - Lucid Games
Warhammer 40,000: Armageddon - The Lordz Games Studio, Flashback Games
'Joe Dever''s Lone Wolf HD Remastered' - Forge Reply
The Witcher Adventure Game - Can Explode
Ode - Ubisoft Reflections
Darksiders III - Gunfire Games, THQ Nordic
Stealth Bastard Deluxe - Curve Studios
'Baldur''s Gate: Enhanced Edition' - Overhaul Games
Miasmata - IonFX
Miner Wars 2081 - Keen Software House Ltd
Watch Dogs 2 - Ubisoft Montreal
Black Mirror - KING Art
Artifact - Valve Software
'Assassin''s Creed: Revelations' - Ubisoft Montreal
Drox Operative - Soldak Entertainment
Cities: Skylines - Natural Disasters - Colossal Order
Just Cause 3 - Avalanche Studios
Injustice 2 - QLOC
DOOM VFR - id Software
Total War: Rome II - Empire Divided - Creative Assembly
X4: Foundations - Egosoft
War of the Vikings - Fatshark AB
Silence of the Sleep - Jesse Makkonen
'The Beginner''s Guide' - Davey Wreden
Heroes of Normandie - Cat Rabbit
Driftmoon - Instant Kingdom
War of the Roses - Fatshark AB
Air Conflicts: Vietnam - bitComposer Games, bitComposer
'Assassin''s Creed Odyssey' - Ubisoft
Mega Man 11 - Capcom
Rage - id Software
Hell Yeah! Wrath of the Dead Rabbit - Arkedo Studio
F1 2013 - Codemasters
Forza Motorsport 7 - Turn 10
Battle Chasers: Nightwar - Airship Syndicate Entertainment
Realms of Ancient War - Wizarbox
Knock-knock - Ice-Pick Lodge
Atlas Reactor - Trion Worlds
Aragami - Lince Works
Road Redemption - Dark Seas Games
Read Only Memories - MidBoss
Raw Data - Survios
A Hat in Time - Gears for Breakfast
Inmates - Iceberg Interactive
Alien: Isolation - Creative Assembly
Transformers: Devastation - PlatinumGames
Skyhill - Mandragora
The Silver Case - Grasshopper Manufacture
Mafia III - Hangar 13
Syndrome - Camel 101
Doki Doki Literature Club! - Team Salvato
Styx: Master of Shadows - Cyanide
Costume Quest 2 - Double Fine Productions
Ride 2 - Milestone S.r.l
WRC 6: World Rally Championship - Kylotonn
Dishonored - Arkane Studios
XCOM: Enemy Unknown - Firaxis Games
Gas Guzzlers Extreme - Gamepires
Sublevel Zero - Sigtrap Games
WRC 5 - Kylotonn
Retro City Rampage - Vblank Entertainment Inc.
'Montague''s Mount' - Polypusher Studios
A Golden Wake - Grundislav Games
'Sid Meier''s Civilization: Beyond Earth - Rising Tide' - Firaxis Games
Masochisia - Oldblood
Middle-earth: Shadow of War - Monolith Productions
Space Hulk: Tactics - Cyanide, Cyanide Studios
My Memory of Us - Juggler Games
The Walking Dead: Episode 4 - Around Every Corner - Telltale Games
Worms Revolution - Team 17
Ryse: Son of Rome - Crytek
Thumper - drool Games, Drool
Ladykiller in a Bind - Love Conquers All Games
Arktika.1 - 4A Games
'Marvel''s Guardians of the Galaxy - Episode 4: Who Needs You' - Telltale Games
Orcs Must Die! - Robot Entertainment
Dead Rising 2: Off the Record - Capcom Vancouver
Of Orcs and Men - Cyanide, Spiders
The Wolf Among Us: Episode 1 - Faith - Telltale Games
The Wolf Among Us - Telltale Games
Gears of War 4 - The Coalition
Duke Nukem 3D: 20th Anniversary World Tour - Gearbox Software
The Missing: JJ Macfield and the Island of Memories - White Owls
The Blackwell Deception - Wadjet Eye Games
The Evil Within 2 - Tango Gameworks
Call of Duty: Black Ops 4 - Treyarch
Might & Magic: Heroes VI - Black Hole Games
Borderlands: The Pre-Sequel - 2K Australia
The Evil Within - Tango Gameworks
The Witcher 3: Wild Hunt - Hearts of Stone - CD Projekt Red Studio
Minecraft: Story Mode - Episode 1: The Order of the Stone - Telltale Games
Shadow Warrior 2 - Flying Wild Hog
Eagle Flight - FunHouse
Dungeons 3 - Realmforge Studios
Democracy 3 - Positech Games
Doom 3 BFG Edition - id Software
Infestation: Survivor Stories (The War Z) - Hammerpoint Interactive
Legend of Grimrock II - Almost Human
Gabriel Knight: Sins of the Fathers 20th Anniversary Edition - Pinkerton Road Studio
Downwell - Moppin
The Age of Decadence - Iron Tower Studio
Human Resource Machine - Tomorrow Corporation
Mushroom 11 - Untame
Take On Helicopters - Bohemia Interactive
Mark of the Ninja - Klei Entertainment
'Borderlands 2: Captain Scarlett and Her Pirate''s Booty' - Gearbox Software
Chivalry: Medieval Warfare - Torn Banner Studios
'Edna & Harvey: Harvey''s New Eyes' - Daedalic Entertainment
Ultimate General: Gettysburg - Game-Labs
A City Sleeps - Harmonix Music Systems
F1 2014 - Codemasters Birmingham
Ravaged - 2 Dawn Games
The Stanley Parable - Davey Wreden
Goodbye Deponia - Daedalic Entertainment
Fist of Jesus - Mutant Games
South Park: The Fractured But Whole - Ubisoft San Francisco
Elex - Piranha Bytes
Rogue Trooper Redux - TickTock Games
RimWorld - Ludeon Studios
Dungeon Defenders - Trendy Entertainment
The Sims 3: Pets - The Sims Studio
Deus Ex: Human Revolution - The Missing Link - Eidos Montreal
FIFA Manager 12 - Bright Future GmbH
Crazy Machines 3 - FAKT Software GmBH, FAKT Software
Return of the Obra Dinn - Lucas Pope
SoulCalibur VI - Bandai Namco Games, Project Soul
Project Warlock - Buckshot Software
Sinner: Sacrifice for Redemption - DarkStar Games
Sword Coast Legends - n-Space
Bomber Crew - Runner Duck
Football Manager 2012 - Sports Interactive
Payday: The Heist - Overkill Software
Before the Echo - Iridium Studios
Cities XL 2012 - Monte Cristo Multimedia, Monte Cristo
Door Kickers - KillHouse Games
Tales From The Borderlands: Episode 5 - The Vault of the Traveler - Telltale Games
Tales from the Borderlands: A Telltale Game Series - Telltale Games
Life is Strange - DONTNOD Entertainment
Life is Strange: Episode 5 - Polarized - DONTNOD Entertainment
Rebel Galaxy - Double Damage Games, Inc., Double Damage Games
Knights of Pen & Paper 2 - Kyy Games
Pulse - Team Pixel Pi, Pixel Pi Games
'Sid Meier''s Civilization VI' - Firaxis Games
Maldita Castilla EX: Cursed Castilla - Locomalito
The Inner World: The Last Wind Monk - Fizbin
Eldritch - Minor Key Games
Warface - Crytek
Dreamfall Chapters Book One: Reborn - Red Thread Games
Screencheat - Samurai Punk
The Legend of Korra - PlatinumGames
DISTRAINT - Jesse Makkonen
Kingdom - Thomas van den Berg
Coast Guard - Reality Twist GmbH, Reality Twist
Battlefield 1 - EA DICE
Giana Sisters: Twisted Dreams - Black Forest Games
Rocksmith 2014 Edition - Ubisoft
The Sims 3: Into the Future - Maxis
LEGO Marvel Super Heroes - TT Games
Tetrobot and Co. - Swing Swing Submarine
Ethan: Meteor Hunter - Seaven Studio
Hotline Miami - Dennaton
Elemental: Fallen Enchantress - Stardock
A Game of Dwarves - Zeal Game Studios
Medal of Honor: Warfighter - Danger Close
How to Survive - EKO Software
'Sid Meier''s Civilization: Beyond Earth' - Firaxis Games
Guild Wars 2: Heart of Thorns - ArenaNet
Warhammer: End Times - Vermintide - Fatshark AB, Fatshark
High Hell - Terri Vellimann
Serious Sam: The Random Encounter - Croteam, Vlambeer
'The Haunted: Hell''s Reach' - ValuSoft
Stronghold 3 - FireFly Studios
Arcania: Fall of Setarrif - Spellbound
Naruto Shippuden: Ultimate Ninja Storm 3 Full Burst - CyberConnect2
Batman: Arkham Origins - Iron Galaxy Studios
FORCED - BetaDwarf
Enslaved: Odyssey to the West - Ninja Theory
Defense Technica - KUNO INTERACTIVE
The Dark Eye: Demonicon - Noumena Productions
Dark Souls III: Ashes of Ariandel - From Software
Farming Simulator 17 - Giants Software
Destiny 2 - Bungie Software, Bungie
Battlefield 3 - EA DICE
The Cursed Crusade - Kylotonn
Deadlight - Tequila Works
'King''s Bounty: Warriors of the North' - Katauri Interactive, Katuri Interactive
Incredipede - Northway Games
FIFA Manager 13 - EA Sports
Farming Simulator 2013 - Giants Software
WRC 4: FIA World Rally Championship - Milestone S.r.l
Batman: The Telltale Series - Episode 3: New World Order - Telltale Games
AER: Memories of Old - Daedalic Entertainment, Forgotten Key
Renegade Ops - Avalanche Studios
Lucius - Shiver Games
Chaos Reborn - Snapshot Games Inc.
Clockwork Empires - Gaslamp Games
Pinball FX 2 - Zen Studios
Dungeon of the Endless - Amplitude Studios
The Park - Funcom
Minecraft: Story Mode - Episode 2: Assembly Required - Telltale Games
Orwell - Osmotic Studios
Through the Woods - Antagonist
Wolfenstein II: The New Colossus - MachineGames
'Assassin''s Creed Origins' - Ubisoft, Ubisoft Montreal
The Book of Unwritten Tales - KING Art
Ignite - Nemesys
Sword of the Stars II: Lords of Winter - Kerberos Productions
Blood of the Werewolf - Scientifically Proven
Lords of the Fallen - City Interactive, Deck 13
BlazeRush - Targem Games
Titanfall 2 - Respawn Entertainment
Primal Carnage - Lukewarm Media
Guns of Icarus Online - Muse Games
Battlefield 4 - EA DICE
The Typing of the Dead: Overkill - Modern Dream
'Deadly Premonition: The Director''s Cut' - Access Games
Master Reboot - Wales Interactive Ltd.
The Legend of Heroes: Trails in the Sky SC - Falcom
Galak-Z: The Dimensional - 17-Bit
Pathologic Classic HD - Ice-Pick Lodge
Call of Cthulhu - Cyanide, Cyanide Studios
Natural Selection 2 - Unknown Worlds Entertainment
Need for Speed: Most Wanted - A Criterion Game - Criterion Games
Cognition: An Erica Reed Thriller Episode 1 - The Hangman - Phoenix Online Studios
Football Manager 2014 - Sports Interactive
Icewind Dale: Enhanced Edition - Black Isle Studios, Beamdog, Overhaul Games
Farming Simulator 15 - Giants Software
The Binding of Isaac: Afterbirth - Nicalis
Spintires: MudRunner - Saber Interactive
inMomentum - Digital Arrow
Painkiller: Hell & Damnation - The Farm 51
Pid - Might and Delight
Sniper Elite: Nazi Zombie Army 2 - Rebellion
'Buzz Aldrin''s Space Program Manager' - Slitherine, Slitherine Group
Hitman - Io Interactive
Zwei: The Ilvard Insurrection - Falcom
Attentat 1942 - Charles University
Bubsy: The Woolies Strike Back - Black Forest Games
Metal Gear Solid V: The Phantom Pain - Kojima Productions
Armello - League of Geeks
Mad Max - Avalanche Studios
Red Goddess: Inner World - Yanim Studio
The Metronomicon - Puuba
Total War: Rome II - Creative Assembly
The Sims 4 - Maxis
Runers - LGK Games
Company of Heroes 2: The British Forces - Relic, Relic Entertainment
Renowned Explorers: International Society - Abbey Games
Act of Aggression - Eugen Systems
Redout - 34BigThings
Seasons After Fall - Swing Swing Submarine
Brothers: A Tale of Two Sons - Starbreeze
The Sims 3 Supernatural - The Sims Studio
'Shad''O' - Okugi Studio
Outlast - Red Barrels
MirrorMoon EP - Santa Ragione
Train Fever - Urban Games
Destiny 2: Forsaken - Bungie Software, Bungie
Planet Alpha - Adrian Lazar
Dead Island - Techland
Warhammer 40,000: Space Marine - Relic
Dead Rising 3: Apocalypse Edition - Capcom Vancouver
Mother Russia Bleeds - Le Cartel Studio
I Am Alive - Ubisoft Shanghai
Starpoint Gemini 2 - Little Green Men
NBA 2K19 - Visual Concepts
Another Sight - Lunar Great Wall Studios
Rock of Ages - ACE Team
Tokyo Dark - Square Enix, Cherrymochi
'Tyranny: Bastard''s Wound' - Obsidian Entertainment
Men of War: Vietnam - Best Way
Valdis Story: Abyssal City - Endless Fluff
Warhammer 40,000: Regicide - Hammerfall Publishing
Project Highrise - SomaSim
Halcyon 6: Starbase Commander - Massive Damage, Inc.
'Hack ''n'' Slash' - Double Fine Productions
Lovers in a Dangerous Spacetime - Asteroid Base
Dragon Age: Inquisition - Trespasser - BioWare
Amnesia: A Machine for Pigs - Frictional Games
Minimum - Human Head Studios
Dropsy - Tendershoot, A Jolly Corpse
Cross of the Dutchman - Triangle Studios
Battlefield 3: Armored Kill - EA DICE
Gateways - Smudged Cat Games
Card Hunter (2013) - Blue Manchu
Aarklash: Legacy - Cyanide, Cyanide Studios
J.U.L.I.A.: Among the Stars - Cardboard Box Entertainment
Pro Evolution Soccer 2018 - Konami
Tooth and Tail - Pocketwatch Games
Red Orchestra 2: Heroes of Stalingrad - Tripwire Interactive
Hard Reset - Flying Wild Hog
Sengoku - Paradox Development Studio
Call of Juarez: The Cartel - Ubisoft
Secret Files 3 - Animation Arts
Volgarr the Viking - Crazy Viking Studios
Legend of Dungeon - Robot Loves Kitty
Pac-Man Championship Edition 2 - Bandai Namco Games
RIVE - Two Tribes
Pro Evolution Soccer 2017 - Konami
ReCore - comcept
Frozen Synapse 2 - Mode 7 Games
Lamplight City - Grundislav Games
Megaquarium - Twice Circled
TrackMania 2 Canyon - Nadeo
Black Mesa - Black Mesa Modification Team
FTL: Faster Than Light - Subset Games
Tryst - BlueGiant Interactive
Event[0] - Ocelot Society
Divinity: Original Sin II - Larian Studios Games Ltd
Dishonored: Death of the Outsider - Arkane Studios
Oriental Empires - Shining Pixel Studios
Shadow of the Tomb Raider - Eidos Montreal
Undertale - tobyfox
Xotic - WXP
King Arthur: Fallen Champions - NeocoreGames
ArcheAge - XLGAMES
Pro Evolution Soccer 2016 - Konami
'Skyshine''s Bedlam' - Skyshine Games
BioShock: The Collection - 2K Games
Diaries of a Spaceport Janitor - Sundae Month
Borderlands 2 - Gearbox Software
F1 2012 - Codemasters
MechWarrior Online - Piranha Games
SPACECOM - FLOW COMBINE
World of Warships - Wargaming.net
Ironclad Tactics - Zachtronics Industries
Foul Play - Mediatonic
Urban Trial Freestyle - Tate Multimedia
Age of Wonders III - Golden Realms - Triumph Studios
Wasteland 2 - InXile Entertainment
Roundabout - No Goblin
Transference - SpectreVision
'The Bard''s Tale IV: Barrows Deep' - InXile Entertainment
60 Parsecs! - Robot Gentleman
F1 2011 - Codemasters
Cognition: An Erica Reed Thriller Episode 4 - The Cain Killer - Phoenix Online Studios
ECHO (2017) - Ultra Ultra
Minecraft: Story Mode Season Two - Episode 3: Jailhouse Block - Telltale Games
Marvel vs. Capcom: Infinite - Capcom
The Gardens Between - The Voxel Agents
Torchlight II - Runic Games
Angry Video Game Nerd Adventures - FreakZone
Takedown: Red Sabre - Serellan LLC
Worlds of Magic - Wastelands Interactive
Batman: The Telltale Series - Episode 2: Children of Arkham - Telltale Games
Wheels of Aurelia - Santa Ragione
Cossacks 3 - GSC Game World
The Bunker - Slendy Interactive, Splendy Games
CrossCode - Radical Fish Games
Star Control: Origins - Stardock
SOMA - Frictional Games
Project CARS 2 - Slightly Mad Studios
Heat Signature - Tom Francis
STONE - Convict Games
Nuclear Dawn - Interwave Studios
Hector: Badge of Carnage - Episode 3: Beyond Reasonable Doom - Straandlooper
Stronghold: Crusader II - FireFly Studios
System Shock: Enhanced Edition - Looking Glass Studios
FIFA 16 - EA Sports
Blood Bowl 2 - Cyanide
Fractured Space - Edge Case Games
Virginia - Variable State
SteamWorld Dig 2 - Image & Form
Guild Wars 2: Path of Fire - ArenaNet
Figment - Bedtime Digital Games
Oil Rush - Unigine Corp, Russia
Railworks 3: Train Simulator 2012 - RailSimulator.com
FIFA 15 - EA Sports
DG2: Defense Grid 2 - Hidden Path Entertainment
Gauntlet (2014) - Warner Bros. Interactive Entertainment
Ancient Space - CreativeForge Games
'Schrodinger''s Cat and the Raiders of the Lost Quark' - Italic Pig
Assault Android Cactus - Witch Beam
A Fistful of Gun - FarmerGnome
Warhammer 40,000: Eternal Crusade - Behaviour Interactive Inc., Behaviour Interactive
Colour Bind - Puppy Punch Productions
Pac-Man Championship Edition DX + - Namco Bandai Games
Nihilumbra - BEAUTIFUN GAMES SL, BeautiFun Games
Scribblenauts Unmasked: A DC Comics Adventure - 5TH Cell
The Raven: Legacy of a Master Thief - A Murder of Ravens - KING Art
Alien Rage - CI Games
Fenix Rage - Green Lava Studios
Else Heart.Break() - Erik Svedang
Cities: Skylines - After Dark - Colossal Order
FIFA Soccer 13 - Electronic Arts
World of Warcraft: Mists of Pandaria - Blizzard Entertainment
Pro Evolution Soccer 2013 - Konami
The Testament of Sherlock Holmes - Frogwares
The Vanishing of Ethan Carter - The Astronauts
Grand Ages: Medieval - Gaming Minds Studios
Valkyria Chronicles 4 - Sega
Pathfinder: Kingmaker - Owlcat Games
The Walking Dead: The Telltale Series - The Final Season Episode 2: Suffer the Children - Telltale Games
Dakar 18 - Bigmoon Entertainment
Shadow Warrior - Flying Wild Hog
Neverending Nightmares - Infinitap Games
FIFA 18 - EA Vancouver
Hob - Runic Games
Ruiner - Reikon Games
Batman: The Enemy Within - Episode 2: The Pact - Telltale Games
Deep Sky Derelicts - Snowhound Games
FIFA Soccer 12 - Electronic Arts
Driver: San Francisco - Ubisoft Reflections
Pro Evolution Soccer 2012 - Konami
The Inner World - Headup Games
Rise of Venice - Kalypso
Forza Horizon 3 - Playground Games
FIFA 17 - EA Sports, EA Vancouver
Clustertruck - LandFall Games, LandFall
Lichtspeer - Lichthund
Rogue Wizards - Spellbind Studios
Life is Strange 2: Episode 1 - Roads - DONTNOD Entertainment
The Binding of Isaac - Edmund McMillen, Florian Himsl
A Game of Thrones: Genesis - Cyanide
Carrier Command: Gaea Mission - Bohemia Interactive
Cortex Command - Data Realms
Total War: WARHAMMER II - Creative Assembly
Vaporum - Fatbot Games
Forza Horizon 4 - Playground Games
Deliver Us The Moon: Fortuna - KeokeN Interactive
Off-Road Drive - Avalon Style
Outland - Housemarque, Knockout Games
Dark Souls II: Crown of the Ivory King - Namco Bandai Games
Sherlock Holmes: Crimes & Punishments - Frogwares
80 Days (2015) - inkle, Cape Guy
Jotun - Thunder Lotus Games
Might & Magic: Heroes VII - Limbic Entertainment
Wuppo - Knuist & Perzik
Cuphead - Studio MDHR
Two Worlds II: Pirates of the Flying Fortress - Reality Pump
Middle-earth: Shadow of Mordor - Monolith Productions
Armikrog - Pencil Test Studios
