The Adventure Pals - Massive Monster
Penny-Punching Princess - Nippon Ichi Software
LEGO City Undercover - TT Games
Pinball FX3: Bethesda Pinball - Zen Studios
Vroom in the Night Sky - Poisoft
Urban Trial Playground - Teyon, Tate Multimedia
Infernium - Carlos Coronado
Graceful Explosion Machine - Vertex Pop
Masters of Anima - Passtech Games
Super Daryl Deluxe - Dan & Gary Games
Bombslinger - Mode4
Rogue Aces - Infinite State Games
Skies of Fury DX - Seed Interactive
Regalia: Of Men and Monarchs - Royal Edition - Pixelated Milk
Burly Men At Sea - Brain&Brain
Shelter Generations - Might and Delight
Mr. Shifty - Team Shifty
Football Manager Touch 2018 - Sports Interactive
'Wonder Boy: The Dragon''s Trap' - Lizardcube
Manticore: Galaxy on Fire - Deep Silver
Nintendo Labo: Toycon 01 Variety Kit - Nintendo
Nintendo Labo: Toycon 02 Robot Kit - Nintendo
The Way Remastered - Puzzling Dream
South Park: The Fractured But Whole - Ubisoft San Francisco
Gal*Gun 2 - Inti Creates
Puyo Puyo Tetris - Sonic Team
Late Shift - Wales Interactive Ltd.
Light Fall - Bishop Games
A Robot Named Fight! - Matt Bitner
Naruto Shippuden: Ultimate Ninja Storm Trilogy - Bandai Namco Games
Saturday Morning RPG - Joystick Labs, LLC
Kamiko - Skipmore
Jotun: Valhalla Edition - Thunder Lotus Games
Mario Kart 8 Deluxe - Nintendo
Iconoclasts - MP2 Games
Flat Heroes - Parallel Circles
Salt and Sanctuary - Ska Studios
Infinite Minigolf - Zen Studios
Dead Cells - Motion Twin
Flipping Death - Zoink!
Overcooked! 2 - Ghost Town Games Ltd.
Sine Mora EX - Grasshopper Manufacture
Okami HD - Capcom
Minit - JW, Kitty, Jukio, and Dom
Ironcast - Dreadbit
Cosmic Star Heroine - Zeboyd Games
Sonic Mania - Tantalus
State of Mind - Daedalic Entertainment
Keep Talking and Nobody Explodes - Steel Crate Games
CastleStorm - Zen Studios
Detective Gallo - Footprints Games
Bad North - Plausible Concept
Morphies Law - Cosmoscope GmbH
Flood of Light - Irisloft
Little Dragons Cafe - Aksys Games
Into the Breach - Subset Games
Victor Vran: Overkill Edition - Haemimont Games
Monster Hunter Generations Ultimate - Capcom
Blade Strangers - Studio Saizensen
Mario + Rabbids: Kingdom Battle - Ubisoft, Ubisoft Milan
The Messenger - Sabotage Studio
Mini Metro - Dinosaur Polo Club
Freedom Planet - GalaxyTrail
Azure Striker Gunvolt: Striker Pack - Inti Creates
League of Evil - Ratalaika Games
Xenoblade Chronicles 2 - Monolith Soft
Monster Boy and the Cursed Kingdom - FDG Entertainment
Toki - Microids
Gear.Club Unlimited 2 - Eden Games Mobile
Nine Parchments - Frozenbyte, Inc.
Caveman Warriors - JanduSoft
Teslagrad - Rain Games
'The Legend of Zelda: Breath of the Wild - The Champions'' Ballad' - Nintendo
Embers of Mirrim - Creative Bytes
Floor Kids - Merj Media
Dimension Drive - 2Awesome Studio
The Sexy Brutale - Cavalier Game Studios
Vostok Inc. - Nosebleed Interactive
Human: Fall Flat - No Brakes Games
Super Smash Bros. Ultimate - Nintendo, HAL Labs, Bandai Namco Games, Sora Ltd.
Katamari Damacy REROLL - Bandai Namco Games
Sega Genesis Classics - Various
Guacamelee! 2 - DrinkBox Studios
Kingdom: Two Crowns - Raw Fury, Noio
EVERSPACE: Stellar Edition - ROCKFISH Games
Desert Child - Oscar Brittain
Pinball FX3 - Zen Studios
The End Is Nigh - Nicalis
GRIS - Nomada Studio
RollerCoaster Tycoon Adventures - Nvizzio Creations
Enter the Gungeon - Dodge Roll
Mutant Mudds Collection - Renegade Kid, Atooi LLC
Gorogoa - Jason Roberts
Yooka-Laylee - Playtonic Games
Bleed - BootdiskRevolution
'Never Stop Sneakin''' - Humble Hearts
Romancing SaGa 2 - Square Enix
Brawlout - Angry Mob Games
Battle Princess Madelyn - Causal Bit Games
Blossom Tales: The Sleeping King - Castle Pixel, LLC.
The Next Penelope - Aurelien Regard
Max: The Curse of Brotherhood - Stage Clear Studios
Mom Hid My Game! - Hap
Tiny Metal - AREA35
The Coma: Recut - Devespresso Games
The Deer God - Cinopt Studios LLC
Sundered: Eldritch Edition - Thunder Lotus Games
Aaero: Complete Edition - Mad Fellows Ltd
Sparkle Unleashed - 10tons
Dynasty Warriors 8: Xtreme Legends - Definitive Edition - Omega Force
SteamWorld Heist: Ultimate Edition - Image & Form
Crypt of the NecroDancer: Nintendo Switch Edition - Brace Yourself Games
Night in the Woods - Infinite Fall
SteamWorld Dig: A Fistful of Dirt - Image & Form
Sky Force Reloaded - Infinite Dreams Inc.
Wargroove - Chucklefish
Dandara - Raw Fury, Long Hat House
Mercenary Kings: Reloaded Edition - Tribute Games
The Darkside Detective - Spooky Doorway
BlazBlue: Central Fiction - Special Edition - Arc System Works
Observer - Bloober Team
ATOMIK: RunGunJumpGun - Gambitious
Aegis Defenders - Humble Bundle
Disc Jam - High Horse Entertainment
Mercenaries Saga Chronicles - RideonJapan,Inc.
Dragon Quest Builders - Square Enix
The Liar Princess and the Blind Prince - Nippon Ichi Software
Owlboy - BlitWorks
The Fall Part 2: Unbound - Over The Moon
The Longest Five Minutes - Nippon Ichi Software
Tetris 99 - Arika, Nintendo
Final Fantasy IX - SquareSoft
Modern Combat: Blackout - Gameloft
Aqua Kitty UDX - Tikipod Limited
Xeodrifter - Atooi LLC
ToeJam & Earl: Back in the Groove - Humanature Studios
Bayonetta 2 - Nintendo
Bayonetta + Bayonetta 2 - PlatinumGames
Bayonetta - Nintendo
'Joe Dever''s Lone Wolf' - Bulkypix, Forge Reply
Fe - Zoink!
'Old Man''s Journey' - Broken Rules
Layers of Fear: Legacy - Bloober Team
X-Morph: Defense - EXOR Studios
Aragami: Shadow Edition - Lince Works
Q.U.B.E. 2 - Toxic Games
Pac-Man Championship Edition 2 Plus - Bandai Namco Games
Membrane - Perfect Hat
Typoman: Revised - Brainseed Factory
Hollow - MMEU
Toki Tori 2 + - Two Tribes
Trials Rising - RedLynx
Outlast: Bundle of Terror - Red Barrels
Payday 2 - Sumo Digital, Overkill Software
Bridge Constructor Portal - ClockStone Software
Ape Out - Gabe Cuzzillo
Stikbold! Dodgeball Adventure! Deluxe - Game Swing
Fitness Boxing - Imagineer Co.,Ltd.
Sega Ages: OutRun - Sega
Bury me, my Love - Plug In Digital
Double Cross - 13AM Games
Super Meat Boy - Team Meat
Furi - The Game Bakers
The Escapists 2 - Team 17, Mouldy Toof Studios
Tales of Vesperia: Definitive Edition - Bandai Namco Games
New Super Mario Bros. U Deluxe - Nintendo
BRAWL - Bloober Team
Onimusha: Warlords - Capcom, NeoBards Entertainment
InnerSpace - PolyKnight Games
Octahedron: Transfixed Edition - Demimonde
Fairy Fencer F: Advent Dark Force - Compile Heart
YIIK: A Postmodern RPG - Ackkstudios
Darkest Dungeon - Red Hook Studios
World to the West - Rain Games
Travis Strikes Again: No More Heroes - Grasshopper Manufacture
Vesta - FinalBoss Games
Baseball Riot - 10tons
ChromaGun - Pixel Maniacs
Shu - Coatsink Software
Lost Sphear - Tokyo RPG Factory
Unruly Heroes - Magic Design Studios
My Memory of Us - Juggler Games / Crunching Koalas
Pikuniku - Sectordub
LEGRAND LEGACY: Tale of the Fatebounds - Another Indie
Celeste - Matt Makes Games Inc.
Super One More Jump - SMG Studio
Fantasy Hero: Unsigned Legacy - Arc System Works
Mages of Mystralia - Borealys Games
Sphinx and the Cursed Mummy - Eurocom
Downwell - Moppin
Tangledeep - Impact Gameworks
Runbow - 13AM Games
Pocket Rumble - Chucklefish
Mushroom Wars 2 - Zillion Whales
Bulb Boy - Bulbware
Implosion - Never Lose Hope - Rayark Inc.
Flip Wars - OVER FENCE CO.,LTD., Over Fence
Vaccine - Rainy Night Creations
Another World - The Digital Lounge
Pato Box - Bromio
'The Lion''s Song' - 'Mi''pu''mi Games'
20XX - Batterystaple Games
Bomber Crew - Runner Duck
Shining Resonance Refrain - Sega
Bomb Chicken - Nitrome
Galak-Z: Variant S - GungHo, 17-Bit
Death Squared - SMG Studio
De Mambo - The Dangerous Kitchen
I and Me - Wish Fang
Octopath Traveler - Square Enix, Acquire
Captain Toad: Treasure Tracker - Nintendo EAD Tokyo , Nintendo Software Technology
Sonic Mania Plus - Sega
Hand of Fate 2 - Defiant Development
Touhou Genso Wanderer Reloaded - Mediascape
Adventure Time: Pirates of the Enchiridion - Bandai Namco Games
Pool Panic - Rekim
Heroki - Picomy
Splatoon 2 - Nintendo
Mega Man X Legacy Collection - Capcom
Mega Man X Legacy Collection 1 + 2 - Capcom
Semblance - Nyamakop
Mega Man X Legacy Collection 2 - Capcom
Fate/Extella: The Umbral Star - Marvelous Inc.
The Banner Saga 3 - Stoic
2064: Read Only Memories INTEGRAL - MidBoss
Candle: The Power of the Flame - Teku Studios 
Crossing Souls - Fourattic
Sleep Tight - We Are Fuzzy
Overcooked!: Special Edition - Team 17
Go Vacation - Bandai Namco Games
Hello Neighbor - tinyBuild
Namco Museum - Namco
Code of Princess EX - Nicalis
Titan Quest - THQ Nordic
BlazBlue: Cross Tag Battle - Arc System Works
Happy Birthdays - Arc System Works
Shaq Fu: A Legend Reborn - Big Deez Productions
Shape of the World - Hollow Tree Games
The Banner Saga 2 - Stoic
Slime-san - Fabraz
Shantae: Half-Genie Hero - WayForward
Sushi Striker: The Way of Sushido - Indies Zero 
Legendary Eleven - Eclipse Games
Hollow Knight - Team Cherry
Fortnite - Epic Games
Paladins: Champions of the Realm - Hi-Rez Studios
Hexologic - MythicOwl
Cars 3: Driven to Win - Avalanche Software
Splatoon 2: Octo Expansion - Nintendo
Mighty Gunvolt Burst - Inti Creates
LEGO The Incredibles - TT Games
ARMS - Nintendo
Flashback - Paul Cuisset
Musynx - PM Studios Inc.
The Lost Child - Kadokawa
Cave Story + - Nicalis
Pode - Henchman & Goon
Oceanhorn: Monster of Uncharted Seas - Cornfox & Bros.
Mario Tennis Aces - Camelot Software Planning
Lumines Remastered - Enhance Games
Mario + Rabbids: Kingdom Battle - Donkey Kong Adventure - Ubisoft Milan
Ys VIII: Lacrimosa of DANA - Falcom
de Blob - Blue Tongue Entertainment
INSIDE - PLAYDEAD
LIMBO - PLAYDEAD
Figment - Bedtime Digital Games
GoNNER - Art in Heart
Wolfenstein II: The New Colossus - Panic Button, MachineGames
Crash Bandicoot N. Sane Trilogy - Vicarious Visions, Toys for Bob
The Legend of Zelda: Breath of the Wild - The Master Trials - Nintendo
Detention - Red Candle Game
Subsurface Circular - Mike Bithell
A Normal Lost Phone - Plug In Digital
Mulaka - Lienzo
The Legend of Zelda: Breath of the Wild - Nintendo
Shovel Knight: Treasure Trove - Yacht Club Games
Shovel Knight: Specter of Torment - Yacht Club Games
Fast RMX - 'Shin''en'
Snipperclips - Cut it out, together! - Nintendo, SFB Games
I Am Setsuna - Tokyo RPG Factory
Skylanders Imaginators - Toys for Bob
Just Dance 2017 - Ubisoft Paris
Super Bomberman R - Konami
1-2-Switch - Nintendo
New Frontier Days: Founding Pioneers - Arc System Works
Scribblenauts Showdown - Warner Bros. Interactive Entertainment
Bleed 2 - BootdiskRevolution
Steredenn: Binary Stars - Plug In Digital
Earthlock - Snow Castle Games, CrossFunction
Assault Android Cactus+ - Witch Beam
VOEZ - Flyhigh Works
Blaster Master Zero - Inti Creates
ACA NeoGeo: Metal Slug 3 - SNK Playmore, Hamster
ACA NeoGeo: Shock Troopers - Saurus
Claybook - Second Order
The Caligula Effect: Overdose - Aquria
Danmaku Unlimited 3 - Doragon Entertainment
Baba Is You - Hempuli Oy, MP2 Games
Captain Toad: Treasure Tracker - Special Episode - Nintendo Software Technology
Clustertruck - tinyBuild
The Long Reach - Painted Black Games
World of Goo - Tomorrow Corporation
Human Resource Machine - Tomorrow Corporation
Little Inferno - Tomorrow Corporation
Last Day of June - Ovosonico
Tesla vs Lovecraft - 10tons
Kirby Star Allies - HAL Labs
The Binding of Isaac: Afterbirth + - Edmund McMillen, Nicalis
'Shantae and the Pirate''s Curse' - WayForward
Attack on Titan 2 - Omega Force
'Chocobo''s Mystery Dungeon: Every Buddy!' - Square Enix
'Slayaway Camp: Butcher''s Cut' - Blue Wizard Digital
Unravel Two - Coldwood Interactive
Othello - Arc System Works
Castle of Heart - 7Levels
Dragon Marked For Death - Inti Creates
Outlast 2 - Red Barrels
Atelier Lydie & Suelle: The Alchemists and the Mysterious Paintings - Koei Tecmo Games
Snake Pass - Sumo Digital
Has-Been Heroes - Frozenbyte, Inc.
Lode Runner Legacy - Tozai Games, Inc.
'Yoshi''s Crafted World' - Good-Feel
Toki Tori - Two Tribes
Shadow Bug - Muro Studios Ltd.
Devious Dungeon - Noodlecake Studios Inc
TumbleSeed - Benedict Fritz, aeiowu, Team TumbleSeed
Donkey Kong Country: Tropical Freeze - Retro Studios
Shantae: Half-Genie Hero - Ultimate Edition - WayForward
Death Road to Canada - Rocketcat Games
Raging Justice - MakinGames
NBA Playgrounds - Saber Interactive
Super Chariot - Frima Studio
One Piece: Pirate Warriors 3 - Deluxe Edition - Koei Tecmo Games
Immortal Redneck - Crema Games
The Fall - Over The Moon
Garage - tinyBuild
Suicide Guy - Chubby Pixel
Minecraft: Switch Edition - 4J Studios
Battle Chasers: Nightwar - Airship Syndicate Entertainment
Wizard of Legend - Contingent99
The Banner Saga 1 - Stoic
FRAMED Collection - Loveshack Entertainment
Yonder: The Cloud Catcher Chronicles - Prideful Sloth
FOX n FORESTS - Bonus Level Entertainment
Thumper - Drool
Little Nightmares: Complete Edition - Tarsier Studios
Hyrule Warriors: Definitive Edition - Koei Tecmo Games
Mega Man Legacy Collection - Capcom
Mega Man Legacy Collection + Mega Man Legacy Collection 2 - Digital Eclipse
Mega Man Legacy Collection 2 - Capcom
Runner3 - Choice Provisions
Disco Dodgeball Remix - Zen Studios
Disgaea 5 Complete - Nippon Ichi Software
Bloodstained: Curse of the Moon - Inti Creates
N++ - Metanet Software Inc.
Jumping Joe & Friends - Vixa Games / QubicGames S.A.
Ultra Street Fighter II: The Final Challengers - Capcom
Ikaruga - Treasure
'Yoku''s Island Express' - Villa Gorilla
Street Fighter: 30th Anniversary Collection - Capcom
Fallen Legion: Rise to Glory - YummyYummyTummy
Pokemon Quest - Game Freak
Legend of Kay Anniversary - Kaiko
Astro Duel Deluxe - Panic Button
West of Loathing - Asymmetric Publications
Just Shapes & Beats - Berzerk Studio
ICEY - X.D. Network Inc.
Smoke and Sacrifice - Solar Sail Games
Milanoir - Italo Games
Transistor - Supergiant Games
Chess Ultra - Ripstone
Super Beat Sports - Harmonix Music Systems
Morphite - Crescent Moon Games
Diablo III: Eternal Collection - Blizzard Entertainment
'Taiko no Tatsujin: Drum ''n'' Fun!' - Bandai Namco Games
Moonlighter - 11 bit studios, Digital Sun
Rogue Legacy - Cellar Door Games
World of Final Fantasy Maxima - Square Enix
Road Redemption - Dark Seas Games, EQ Games
GRIP: Combat Racing - Caged Element Inc.
Carnival Games for Nintendo Switch - Mass Media
Farming Simulator: Nintendo Switch Edition - Giants Software
Uno - Ubisoft
Sonic Forces - Sonic Team
Valiant Hearts: The Great War - Ubisoft Montpellier
Mercenaries Wings: The False Phoenix - RideonJapan,Inc.
Snipperclips Plus: Cut It Out, Together! - SFB Games
DOOM - id Software, Panic Button
Cat Quest - The Gentlebros
SNK 40th Anniversary Collection - SNK
Rocket League - Psyonix
L.A. Noire - Team Bondi, Virtuos
Ittle Dew 2+ - Ludosity Interactive
Lumo - Rising Star Games
LEGO Marvel Super Heroes 2 - TT Games
Batman: The Telltale Series - Telltale Games
RiME - Tantalus
'Sid Meier''s Civilization VI' - Aspyr
'Pokemon: Let''s Go, Eevee!' - Game Freak
'Pokemon: Let''s Go, Pikachu!' - Game Freak
The Elder Scrolls V: Skyrim - Bethesda Game Studios, Iron Galaxy Studios
RIVE: Ultimate Edition - Two Tribes
VVVVVV - Terry Cavanagh
Aces of the Luftwaffe: Squadron - HandyGames
Battle Chef Brigade - Trinket Studios
SUPERBEAT: XONiC - Nurijoy
Gear.Club Unlimited - Eden Games Mobile
'Unbox: Newbie''s Adventure' - Prospect Games
Portal Knights - Keen Games
Nidhogg 2 - Messhof
Worms W.M.D - Team 17
Mantis Burn Racing - VooFoo Studios
Crimsonland - 10tons
This War of Mine: Complete Edition - 11 bit studios
Resident Evil: Revelations Collection - Capcom
Resident Evil: Revelations - Capcom
Resident Evil: Revelations 2 - Capcom
Horizon Chase Turbo - Aquiris Game Studio
R-Type Dimensions EX - Southend Interactive
ABZU - Giant Squid
Cattails - Falcon Development
NAIRI: Tower of Shirin - Homebear Studios, HomeBearStudio
Asterix & Obelix XXL 2 - Etranges Libellules
OkunoKA - Caracal Games
ARK: Survival Evolved - Studio Wildcard
Mega Man 11 - Capcom
Lovers in a Dangerous Spacetime - Asteroid Base
'Overcooked! 2: Surf ''n'' Turf' - Ghost Town Games Ltd.
Stardew Valley - ConcernedApe
Axiom Verge - Tom Happ
Earth Atlantis - Pixel Perfex
Super Mario Party - Nintendo, Nd Cube
Oxenfree - Night School Studio
Guacamelee! Super Turbo Championship Edition - DrinkBox Studios
Disgaea 1 Complete - Nippon Ichi Software
Tiny Barbarian DX - StarQuail
88 Heroes: 98 Heroes Edition - Bitmap Bureau
Touhou Kobuto V: Burst Battle - CUBETYPE
Child of Light - Ubisoft Montreal
Tricky Towers - WeirdBeard
Wulverblade - Darkwind Media
The Flame in the Flood - The Molasses Flood
Yono and the Celestial Elephants - Neckbolt
Neon Chrome - 10tons
The World Ends with You: Final Remix - h.a.n.d. Inc., Jupiter Corporation
Valkyria Chronicles - Sega
LEGO DC Super-Villains - TT Games
Starlink: Battle for Atlas - Ubisoft Toronto
Warriors Orochi 4 - Omega Force
Rogue Trooper Redux - Rebellion
The Jackbox Party Pack 5 - Jackbox Games, Inc.
The Room - Fireproof Games
Zarvot - Snowhydra llc
SINNER: Sacrifice for Redemption - Another Indie
The Count Lucanor - Baroque Decay
JYDGE - 10tons
Spelunker Party! - Tozai Games
Dark Souls Remastered - From Software
Syberia - Koalabs Studio
Fire Emblem Warriors - Omega Force
Poi: Explorer Edition - PolyKid
WindJammers - Data East, DotEmu
Just Dance 2019 - Ubisoft Paris
Nickelodeon Kart Racers - Maximum Games
The Mummy Demastered - WayForward
Just Dance 2018 - Ubisoft Paris
This is the Police - Weappy Studio
Nights of Azure 2: Bride of the New Moon - Gust
Pinstripe - Armor Games
Friday the 13th: Killer Puzzle - Blue Wizard Digital
Splasher - Splashteam
Time Recoil - 10tons
'My Hero One''s Justice' - Bandai Namco Games
Super Mario Odyssey - Nintendo
Yomawari: The Long Night Collection - Nippon Ichi Software
LEGO Harry Potter Collection - Warner Bros. Interactive Entertainment
Mutant Football League: Dynasty Edition - Nighthawk Interactive
Save me Mr Tako: Tasukete Tako-San - Nicalis
Gal Metal - DMM GAMES
Monopoly for Nintendo Switch - Asobo Studio, Engine Software
Planet Alpha - Adrian Lazar
LEGO Worlds - TT Games
Hyper Light Drifter - Heart Machine
NeuroVoider - Flying Oak Games
Lichtspeer: Double Speer Edition - Crunching Koalas, Lichthund
SNK Heroines: Tag Team Frenzy - SNK Corporation
Rayman Legends: Definitive Edition - Ubisoft Montpellier, Pasta Games
Bastion - Supergiant Games
'Wasteland 2: Director''s Cut' - InXile Entertainment
Old School Musical - La Moutarde
Final Fantasy XV Pocket Edition HD - Square Enix
Cities: Skylines - Nintendo Switch Edition - Tantalus
Senran Kagura Reflexions - Honey Parade Games
Semispheres - Vivid Helix
Xenoblade Chronicles 2: Torna ~ The Golden Country - Monolith Soft
Nintendo Labo: Toycon 03 Vehicle Kit - Nintendo
NBA 2K18 - Visual Concepts
Robonauts - QubicGames
Undertale - tobyfox
'Capcom Beat ''Em Up Bundle' - Capcom
Labyrinth of Refrain: Coven of Dusk - Nippon Ichi Software
Velocity 2X - FuturLab
The Gardens Between - The Voxel Agents
SteamWorld Dig 2 - Image & Form
Thimbleweed Park - Ron Gilbert and Gary Winnick, Terrible Toybox
'Broken Sword 5 - The Serpent''s Curse' - Ravenscourt
Pokken Tournament DX - Bandai Namco Games
Dragon Ball: Xenoverse 2 - Dimps Corporation
Valkyria Chronicles 4 - Sega
Arena of Valor - Tencent, Tencent Games
Giana Sisters: Twisted Dreams - Owltimate Edition - Black Forest Games
FIFA 19 - EA Sports
The Escapists: Complete Edition - Mouldy Toof Studios
This is the Police 2 - Weappy Studio
Wandersong - Dumb and Fat Games
Armello - League of Geeks
Golf Story - SideBar Games
Conga Master Party! - Rising Star Games
BUTCHER - Transhuman Design
Picross S - Jupiter Corporation
Astro Bears Party - QubicGames
Dragon Ball FighterZ - Arc System Works
FIFA 18 - EA Vancouver
One Piece: Unlimited World Red - Deluxe Edition - Ganbarion
Marble It Up! - Bad Habit Productions
