Mercenary Kings - Tribute Games
'Adam''s Venture: Origins' - Vertigo Games
Minit - JW, Kitty, Jukio, and Dom
The Adventure Pals - Massive Monster
Island Time VR - Flight School Studio
Crisis on the Planet of the Apes VR - Imaginati
Persona 5 - Atlus
LEGO City Undercover - TT Games
Blackwood Crossing - PaperSeven
PaRappa the Rapper Remastered - NanaOn-Sha, Sony Interactive Entertainment
Drawn to Death - SCEA San Diego Studios, Sony Interactive Entertainment
DiRT Rally - Codemasters
Enter the Gungeon - Dodge Roll
Stikbold! A Dodgeball Adventure - Reign Bros
Star Wars Battlefront: Outer Rim - EA DICE
Dead Star - Armature Studio
Bastion - Supergiant Games
Dark Souls II: Scholar of the First Sin - From Software
Stealth Inc 2: A Game of Clones - Curve Digital
Bulletstorm: Full Clip Edition - People Can Fly
LEGO The Hobbit - TT Games
'Strike Suit Zero: Director''s Cut' - Born Ready Games
King Oddball - 10tons Ltd, 10tons
'Shantae and the Pirate''s Curse' - WayForward
Tower of Guns - Terrible Posture Games
Owlboy - BlitWorks
Masters of Anima - Passtech Games
Call of Duty: WWII - The War Machine - Sledgehammer Games
Regalia: Of Men and Monarchs - Royal Edition - Pixelated Milk
Rick and Morty: Virtual Rick-ality - Owlchemy Labs
Super Daryl Deluxe - Dan & Gary Games
Time Carnage - Wales Interactive Ltd.
Extinction - Iron Galaxy Studios
The Sexy Brutale - Abstraction Games, Tequila Works, Cavalier Game Studios
Aaero - Mad Fellows Ltd
Cosmic Star Heroine - Zeboyd Games
Starblood Arena - WhiteMoon Dreams
Yooka-Laylee - Playtonic Games
Dark Souls III - From Software
Ratchet & Clank - Insomniac Games
Stories: The Path of Destinies - Spearhead Games
Rogue Aces - Infinite State Games
Final Fantasy XIV Online: A Realm Reborn - Square Enix
Mortal Kombat X - Warner Bros. Interactive Entertainment, NetherRealm Studios
Teslagrad - Rain Games
Titan Souls - Acid Nerve
WE ARE DOOMED - Vertex Pop
Flinthook - Tribute Games
Trials Fusion - RedLynx
Yakuza 6: The Song of Life - Ryu ga Gotoku Studios
'Wonder Boy: The Dragon''s Trap' - Lizardcube
The Disney Afternoon Collection - Capcom
Full Throttle Remastered - Double Fine Productions
'Marvel''s Guardians of the Galaxy - Episode 1: Tangled Up in Blue' - Telltale Games
Shiness: The Lightning Kingdom - Enigami
The Silver Case - Grasshopper Manufacture
Late Shift - Wales Interactive Ltd.
Invisible, Inc. Console Edition - Klei Entertainment
Call of Duty: Black Ops III - Eclipse - Treyarch
Pang Adventures - Pasta Games
Koi - Oasis Games
God of War - SCE Santa Monica
Shovel Knight - Yacht Club Games
Ziggurat - Milkstone Studios
The Evil Within: The Consequence - Tango Gameworks
'Assassin''s Creed Chronicles: China' - Climax Group, Climax Studios
Infinity Runner - Wales Interactive Ltd.
UEFA EURO 2016 - Konami
De-formers - Ready at Dawn
Octodad: Dadliest Catch - Kevin Zuhn
Cel Damage HD - Finish Line Games
BRAWL - Bloober Team
Statik - Tarsier Studios
Outlast 2 - Red Barrels
The Swords of Ditto - One Bit Beyond
Gal*Gun 2 - Inti Creates
What Remains of Edith Finch - Giant Sparrow
Puyo Puyo Tetris - Sega, Sonic Team
Dragon Quest Heroes II - Omega Force
Symphony of the Machine - Stirfire Studios
The Walking Dead: The Telltale Series - A New Frontier Episode 4: Thicker than Water - Telltale Games
Sniper: Ghost Warrior 3 - City Interactive
Syberia 3 - Microids
ZEN Pinball 2: Aliens Vs. Pinball - Zen Studios
Hitman - Episode 2: Sapienza - Io Interactive
'King''s Quest Chapter 3: Once Upon a Climb' - The Odd Gentlemen
Alienation - Housemarque
The Walking Dead: Michonne - Episode 3: What We Deserve - Telltale Games
The Magic Circle: Gold Edition - Question
Rocketbirds 2: Evolution - Ratloop Asia Pte Ltd
Party Hard - Pinokl Games
Broken Age - Double Fine Productions
Tropico 5 - Haemimont, Haemimont Games
Omega Quintet - Compile Heart
Project Root - Pablo Testa
Little Nightmares - Tarsier Studios
Child of Light - Ubisoft Montreal
Star Wars Pinball: Heroes Within - Zen Studios
The Amazing Spider-Man 2 - Beenox
Daylight - Zombie Studios
Shadow Tactics: Blades of the Shogun - Mimimi Productions
The Long Dark - Hinterland
CastleStorm: Virtual Reality - Zen Studios
Patapon - Sony Interactive Entertainment
Dino Frontier - Uber Entertainment
Overcooked! - Ghost Town Games Ltd.
ABZU - Giant Squid
Tricky Towers - WeirdBeard B.V., WeirdBeard
Batman: The Telltale Series - Episode 1: Realm of Shadows - Telltale Games
Gal*Gun: Double Peace - Alchemist, Inti Creates
Galak-Z: The Dimensional - 17-Bit
The Castle Game - Neptune Interactive Inc.
Submerged - Uppercut Games, Uppercut Games Pty Ltd
The Swapper - Facepalm Games
Road Not Taken - Spry Fox
Dead Cells - Motion Twin
Overcooked! 2 - Ghost Town Games Ltd.
H1Z1: Battle Royale - Sony Online Entertainment, Daybreak Games
'Hellblade: Senua''s Sacrifice' - Ninja Theory
Sine Mora EX - Digital Reality
LawBreakers - Boss Key Productions
Mega Man Legacy Collection 2 - Capcom, Bullets
Batman: The Enemy Within - Episode 1: The Enigma - Telltale Games
'No Man''s Sky' - Hello Games
Brut@l - Stormcloud Games Limited
Madden NFL 19 - EA Tiburon
We Happy Few - Compulsion Games
Brothers: A Tale of Two Sons - Starbreeze
'Everybody''s Gone to the Rapture' - The Chinese Room
Gauntlet: Slayer Edition - Arrowhead Game Studios
Toy Soldiers: War Chest - Krome Studios
Goat Simulator - Coffee Stain Studios
Hohokum - Honeyslug Ltd
Surgeon Simulator: Anniversary Edition - Bossa Studios
The Walking Dead: The Telltale Series - The Final Season Episode 1: Done Running - Telltale Games
Phantom Doctrine - CreativeForge Games
'Death''s Gambit' - White Rabbit Interactive
Undertale - tobyfox
Sonic Mania - SegaSoft, Sega, PagodaWest Games
Cities: Skylines - PlayStation 4 Edition - Tantalus
Observer - Bloober Team
Matterfall - Housemarque, XDEV
Sudden Strike 4 - Kalypso
Agents of Mayhem - Volition Inc.
State of Mind - Daedalic Entertainment
Bound - SCE Santa Monica, Plastic Studios
Hitman - Episode 4: Bangkok - Io Interactive
Uno - Ubisoft Chengdu
Grow Up - Ubisoft Reflections
Tales From The Borderlands: Episode 4 - Escape Plan Bravo - Telltale Games
Adventures of Pip - TicToc Games
'Pure Hold ''Em' - VooFoo Studios
Volume - Mike Bithell
Zombi - Ubisoft Montpellier, Straight Right
Zero Escape: Zero Time Dilemma - Aksys Games
Diablo III: Ultimate Evil Edition - Blizzard Entertainment
Plants vs Zombies: Garden Warfare - PopCap
CounterSpy - Dynamighty
The Last Tinker: City of Colors - LOOT Entertainment
The Golf Club - HB Studios Multimedia
F1 2016 - Codemasters
Risen 3: Titan Lords - Enhanced Edition - Piranha Bytes
Guacamelee! 2 - DrinkBox Studios
Shenmue I & II - Sega, d3t Ltd
All-Star Fruit Racing - 3DClouds.it
Thimbleweed Park - Ron Gilbert and Gary Winnick
Uncharted: The Lost Legacy - Naughty Dog
Madden NFL 18 - Electronic Arts
The Escapists 2 - Mouldy Toof Studios
ChromaGun - Pixel Maniacs
White Day: A Labyrinth Named School - ROIGAMES Inc.
'Marvel''s Guardians of the Galaxy - Episode 3: More Than A Feeling' - Telltale Games
INSIDE - PLAYDEAD
Deus Ex: Mankind Divided - Eidos Montreal
Madden NFL 17 - EA Sports
Metrico+ - Digital Dreams
The King of Fighters XIV - SNK Playmore, SNK Corporation
Worms W.M.D - Team 17
Alone With You - Benjamin Rivers
Valley - Blue Isle Studios
Armikrog - Pencil Test Studios
Warhammer 40,000: Inquisitor - Martyr - Maximum Games
F1 2018 - Codemasters
Little Dragons Cafe - Aksys Games
Madden NFL 16 - EA Sports
Dishonored: Definitive Edition - Arkane Studios
Until Dawn - SuperMassive Games
Mega Man Legacy Collection - Digital Eclipse
One Piece: Pirate Warriors 3 - Omega Force
Back to Bed - Bedtime Digital Games, LOOT Interactive
I Am Bread - Just Add Water, Bossa Studios
Calvino Noir - Calvino Noir Ltd.
F1 2017 - Codemasters
One Piece: Unlimited World Red - Deluxe Edition - Ganbarion
Metro Redux - 4A Games
ZEN Pinball 2: The Walking Dead - Zen Studios
Madden NFL 15 - EA Sports
inFamous: First Light - Sucker Punch
Rock of Ages 2: Bigger & Boulder - ACE Team
Yakuza Kiwami 2 - Sega, Ryu ga Gotoku Studios
Firewall Zero Hour - Sony Interactive Entertainment, First Contact Entertainment
Pro Evolution Soccer 2019 - Konami
Fire Pro Wrestling World - Spike Chunsoft, ZEX corporation
The Golf Club 2019 featuring PGA Tour - HB Studios Multimedia
Donut County - Ben Esposito
Strange Brigade - Rebellion
Pillars of Eternity: Complete Edition - Obsidian Entertainment, Paradox Arctic
Redout - 505 Games
Yakuza Kiwami - Ryu ga Gotoku Studios
The Metronomicon: Slay the Dance Floor - Puuba
'Everybody''s Golf' - SCEI, Clap Hanz
WindJammers - DotEmu
Sparc - CCP, CCP Games
Resident Evil: Revelations - Capcom
Warriors All-Stars - Omega Force
Absolver - Sloclap
ARK: Survival Evolved - Studio Wildcard
Disney Infinity 3.0 Edition - Avalanche Software
Resident Evil 4 - Capcom
Hatsune Miku: Project Diva X - Sega
Hue - Fiddlesticks Games
Strike Vector EX - Strike Vector Team, Ragequit Corporation
Attack on Titan - Omega Force
Assetto Corsa - Kunos Simulazioni
God Eater 2: Rage Burst - Shift
Livelock - Tuque Games
Fallout 4: Nuka-World - Bethesda Game Studios
Verdun - Abstraction Games, Blackmill Games
One Way Trip - Beret Applications LLC
Life is Strange: Before the Storm - Episode 1: Awake - Deck Nine Games
Life is Strange: Before the Storm - Deck Nine Games
Last Day of June - Ovosonico
Divinity: Original Sin II - Definitive Edition - Larian Studios Games Ltd
Naruto to Boruto: Shinobi Striker - CyberConnect2, Soleil
Just Cause 3 - Avalanche Studios
'Tom Clancy''s Rainbow Six Siege' - Ubisoft Montreal
Deponia - Daedalic Entertainment
The Dwarves - Nordic Games Publishing
DOOM VFR - id Software
Game of Thrones: Episode One - Iron From Ice - Telltale Games
Secret Ponchos - Switchblade Monkeys
The Crew - Ubisoft Reflections, Ivory Tower
Dariusburst: Chronicle Saviours - Pyramid
Steep - Ubisoft Annecy
Escape Plan - Fun Bits
Tiny Brains - Spearhead Games
Lara Croft GO - Square Enix
Ultimate Marvel vs. Capcom 3 - Capcom
Let It Die - Grasshopper Manufacture
Surgeon Simulator: Experience Reality - Bossa Studios
Monster Boy and the Cursed Kingdom - FDG Entertainment
Subnautica - Unknown Worlds Entertainment, Panic Button
Thronebreaker: The Witcher Tales - CD Projekt Red Studio
Mutant Year Zero: Road to Eden - The Bearded Ladies Consulting
Persona Dancing: Endless Night Collection - Atlus
Persona 3: Dancing in Moonlight - Atlus
Persona 5: Dancing in Starlight - Atlus
Just Cause 4 - Avalanche Studios
The Council - Episode 5: Checkmate - Big Bad Wolf
Nuclear Throne - Vlambeer
Fat Princess Adventures - SCE Santa Monica, Fun Bits
GUNS UP! - Valkyrie Entertainment
A Hat in Time - Gears for Breakfast
'Dead Rising 4: Frank''s Big Package' - Capcom Vancouver
Steep: Road to the Olympics - Ubisoft Annecy
Destiny 2: Curse of Osiris - Bungie
The Last Guardian - SCE Japan Studio
Werewolves Within - Ubisoft
The Last Remnant Remastered - Square Enix
'PlayerUnknown''s Battlegrounds' - PUBG Corporation
Earth Defense Force 4.1: The Shadow of New Despair - Sandlot
Zotrix - ZeroBit Games
Tokyo Xanadu eX+ - Falcom
Lara Croft and the Temple of Osiris - Nixxes Software
Tennis in the Face - 10tons Ltd, 10tons
Destiny: The Dark Below - Bungie
LocoRoco 2 Remastered - SCE Japan Studio
Doki-Doki Universe - SCEA, Humanature Studios
Earth Defense Force 5 - Sandlot
Gungrave VR - IGGYMOB
Okami HD - Capcom
Resident Evil 7: biohazard - End of Zoe - Capcom
Resident Evil 7: biohazard - Not a Hero - Capcom
Gang Beasts - Boneloaf
Nine Parchments - Frozenbyte, Inc.
Stardew Valley - Sickhead Games, LLC, Eric Barone
I Expect You To Die - Schell Games
Batman: The Telltale Series - Episode 5: City of Light - Telltale Games
The Little Acre - Curve Digital
Bridge Constructor - ClockStone Software
Drive!Drive!Drive! - different cloth
Borderlands 2 VR - Gearbox Software
'Assassin''s Creed Syndicate: Jack the Ripper' - Ubisoft Quebec
'King''s Quest Chapter 2: Rubble Without a Cause' - The Odd Gentlemen
Romancing SaGa 2 - SquareSoft, Square Enix
Super Mega Baseball - Metalhead Software
Guilty Gear Xrd -SIGN- - Arc System Works
Loadout - Edge of Reality
The Pinball Arcade - Farsight Studios
flOw - SuperVillain Studios
Nippon Marathon - Onion Soup
'Assassin''s Creed IV: Black Flag - Freedom Cry' - Ubisoft Montreal
Shooty Fruity - nDreams
Life is Strange: Before the Storm - Episode 3: Hell is Empty - Deck Nine Games
Shantae: Half-Genie Hero - WayForward
The Walking Dead: The Telltale Series - A New Frontier Episode 1: Ties That Bind Part One - Telltale Games
The Walking Dead: The Telltale Series - A New Frontier Episode 2: Ties That Bind Part Two - Telltale Games
Wild Guns Reloaded - Natsume, NATSUME ATARI Inc.
Lethal VR - Team 17
Battle Princess Madelyn - Causal Bit Games
'Marvel''s Spider-Man: Silver Lining' - Insomniac Games
Minecraft: Story Mode - Episode 4: A Block and a Hard Place - Telltale Games
ZEN Pinball 2 - Zen Studios
8-Bit Hordes - Petroglyph
Crypt of the NecroDancer - Brace Yourself Games
Gravity Rush Remastered - Bluepoint Games
Digimon Story Cyber Sleuth - Media Vision
Not a Hero - roll7
Call of Duty: Black Ops III - Awakening - Treyarch
Megadimension Neptunia VII - Idea Factory, Compile Heart
Amazing Discoveries In Outer Space - Cosmic Picnic
Nitroplus Blasterz: Heroines Infinite Duel - Examu, Marvelous Inc.
Apotheon - Alientrap
Game of Thrones: Episode Two - The Lost Lords - Telltale Games
Naruto Shippuden: Ultimate Ninja Storm 4 - Road to Boruto Expansion - CyberConnect2
Outlast - Red Barrels
Apex Legends - Respawn Entertainment
Monster Energy Supercross:The Official Videogame 2 - Milestone S.r.l
Melbits World - Melbot Studios
'The Mage''s Tale' - InXile Entertainment
How to Survive 2 - 505 Games
Shadow of the Colossus - Bluepoint Games, SCE Japan Studio
Bleed 2 - BootdiskRevolution
The LEGO Movie Videogame - TT Games
Nioh - Team Ninja
'Kitty Powers'' Matchmaker' - STELLAR ENTERTAINMENT SOFTWARE LTD
Uncanny Valley - Cowardly Creations
God Eater 3 - Bandai Namco Games
Lovers in a Dangerous Spacetime - Asteroid Base
Naruto Shippuden: Ultimate Ninja Storm 4 - CyberConnect2
Unravel - Coldwood Interactive
Dying Light: The Following - Techland
Firewatch - Campo Santo
Arslan: The Warriors of Legend - Omega Force
'Assassin''s Creed Chronicles: Russia' - Ubisoft, Climax Studios
Under Night In-Birth Exe:Late[st] - French-Bread
The Seven Deadly Sins: Knights of Britannia - Bandai Namco Games, NATSUME ATARI Inc.
Minutes - Red Phantom Games
Evolve - Turtle Rock Studios
Unmechanical: Extended Edition - Grip Games
Super Stardust Ultra - d3t Ltd
The Liar Princess and the Blind Prince - Nippon Ichi Software
Conarium - Zoetrope Interactive
Sprint Vector - Survios
Crossing Souls - Fourattic
Kingdom Come: Deliverance - Warhorse Studios
Monster Energy Supercross: The Official Videogame - Milestone S.r.l
Dynasty Warriors 9 - Omega Force
Intruders: Hide and Seek - Tessera Studios
For Honor - Ubisoft Montreal
Flywrench - Messhof
Sniper Elite 4 - Rebellion
Ride 2 - Milestone S.r.l
Resident Evil 7: biohazard - Banned Footage Vol. 2 - Capcom
Secret of Mana - Square Enix, Q Studios
Metro Exodus - 4A Games
Far Cry New Dawn - Ubisoft Montreal
ToeJam & Earl: Back in the Groove - Humanature Studios
Jump Force - Spike Chunsoft Co. Ltd., Spike Chunsoft
Street Fighter V - Capcom
Layers of Fear - Bloober Team
Rainbow Moon - SideQuest Studios
TRON RUN/r - Sanzaru Games
Mitsurugi Kamui Hikae - Zenith Blue
Pixel Piracy - Abstraction Games
Fe - Zoink!
Resogun: Defenders - Housemarque
Hand of Fate - Defiant Development
Dead or Alive 5: Last Round - Team Ninja
Pillar - MichaelArts
Q*bert: Rebooted - LOOT Entertainment
Rayman Legends - Ubisoft Montpellier
Strider - Double Helix Games
ChromaGun VR - Pixel Maniacs
The Order: 1886 - Ready at Dawn, SCE Santa Monica
Apex Construct - Fast Travel Games
The Station - The Station
Metal Gear Survive - Konami
Massira - Frost Monkey Games
Night in the Woods - Infinite Fall
Chime Sharp - Chilled Mouse
Psychonauts in The Rhombus of Ruin - Double Fine Productions
Berserk and the Band of the Hawk - Omega Force
Malicious Fallen - Alvion
Rad Rodgers - THQ Nordic
Anthem - BioWare
Plants vs Zombies: Garden Warfare 2 - PopCap
Toki Tori 2 + - Two Tribes
Hitman GO: Definitive Edition - Square Enix Montreal
Far Cry Primal - Ubisoft Montreal
The Walking Dead: Michonne - Episode 1: In Too Deep - Skybound LLC
'Agatha Christie''s The ABC Murders' - Microids
Foul Play - Mediatonic
Deus Ex: Mankind Divided - A Criminal Past - Eidos Montreal
Forma.8 - MixedBag Srl
Sword Art Online: Fatal Bullet - Dimps Corporation
Past Cure - Phantom 8
Resident Evil: Revelations 2 - Episode 1: Penal Colony - Capcom
Dragon Ball: Xenoverse - Dimps Corporation
Middle-earth: Shadow of Mordor - The Bright Lord - Monolith Productions
Dynasty Warriors 8 Empires - Omega Force
Thief - Eidos Montreal
Basement Crawl - Bloober Team
NieR: Automata - Game of the YoRHa Edition - PlatinumGames
DiRT Rally 2.0 - Codemasters
Trials Rising - RedLynx
Stellaris: Console Edition - Paradox Development Studio
The LEGO Movie 2 Videogame - TT Games
Moss - Polyarc
Blasters of the Universe - Secret Location
Immortal Redneck - CremaGames, Crema Games
de Blob 2 - Blue Tongue Entertainment
Gravel - Milestone S.r.l
Mulaka - Lienzo
Horizon Zero Dawn - Guerrilla
Torment: Tides of Numenera - InXile Entertainment
The Incredible Adventures of Van Helsing: Extended Edition - NeocoreGames
Ghost Blade HD - HUCAST
Dying: Reborn - Nekcom
Fimbul - Zaxis
Amplitude - Harmonix Music Systems
Hardware: Rivals - SCEA
'Don''t Starve: Console Edition' - Klei Entertainment
Little Red Lie - WZOGI
Hatsune Miku: Project Diva Future Tone - Colorful Tone - Sega
Hatsune Miku: Project Diva Future Tone - Future Sound - Sega
Tales of Vesperia: Definitive Edition - Bandai Namco Games, QLOC
Hitman HD Enhanced Collection - IO Entertainment
Gone Home: Console Edition - The Fullbright Company, Midnight City
Star Wars Pinball: The Force Awakens - Zen Studios
The Banner Saga - Stoic
Tharsis - Choice Provisions
'Assassin''s Creed Unity: Dead Kings' - Ubisoft, Ubisoft Montreal
Far Cry 4: Escape from Durgesh Prison - Ubisoft Montreal
'Assassin''s Creed Chronicles: India' - Ubisoft, Climax Studios
The Walking Dead: The Telltale Series - The Final Season Episode 3: Broken Toys - Telltale Games, Skybound Games
Onimusha: Warlords - Capcom, NeoBards Entertainment
Vane - Friend & Foe
Street Fighter V: Arcade Edition - Capcom
InnerSpace - PolyKnight Games
Kerbal Space Program: Enhanced Edition - BlitWorks
Beholder: Complete Edition - Warm Lamp Games
2064: Read Only Memories - MidBoss
The Flame in the Flood: Complete Edition - The Molasses Flood
Fate/Extella: The Umbral Star - Marvelous Inc.
Mighty Morphin Power Rangers: Mega Battle - Bandai Namco Games
YIIK: A Postmodern RPG - Ackkstudios
Ace Combat 7: Skies Unknown - Project Aces 
World of Tanks - Wargaming.net
Klaus - La Cosa Entertainment
The Deadly Tower of Monsters - ACE Team
Tachyon Project - Eclipse Games
Resident Evil 0: HD Remaster - Capcom
Attractio - GameCoder Studios
'Digimon Story Cyber Sleuth: Hacker''s Memory' - Media Vision
Resident Evil HD Remaster - Capcom
Saints Row IV: Re-Elected - Volition Inc.
Citizens of Earth - Eden Industries
Saints Row IV: Re-Elected & Gat Out of Hell - Volition Inc.
Saints Row: Gat Out of Hell - Volition Inc.
Gravity Rush 2 - SCE Japan Studio
Batman: The Enemy Within - Episode 4: What Ails You - Telltale Games
'A Fisherman''s Tale' - Innerspace VR
Senran Kagura Burst Re:Newal - Honey Parade Games
Iconoclasts - Joakim Sandberg, Konjak
'Assassin''s Creed Origins: The Hidden Ones' - Ubisoft Montreal
Lost Sphear - Tokyo RPG Factory
The Inpatient - SuperMassive Games
Resident Evil 7: biohazard - Capcom
Yakuza 0 - Ryu ga Gotoku Studios
Tales of Berseria - Bandai Namco Games
Kingdom Hearts HD 2.8 Final Chapter Prologue - Square Enix
Moto Racer 4 - PQube
Life is Strange 2: Episode 2 - Rules - DONTNOD Entertainment
Celeste - Matt Makes Games Inc.
Resident Evil 2 - Capcom R&D Division 1
The Witness - Thekla, Inc
'LEGO Marvel''s Avengers' - TT Games
Monster Hunter: World - Capcom
Dragon Ball FighterZ - Arc System Works
Grim Fandango Remastered - Double Fine Productions
Dying Light - Techland
Tomb Raider: Definitive Edition - Crystal Dynamics, Nixxes Software
This War of Mine: The Little Ones - 11 bit studios
Sebastien Loeb Rally Evo - Milestone S.r.l
Kingdom Hearts III - Square Enix
The Hong Kong Massacre - VRESKI
Genesis Alpha One - Radiation Blue
Life is Strange: Episode 1 - Chrysalis - DONTNOD Entertainment
Double Dragon IV - Arc System Works
Wulverblade - Darkwind Media
EA Sports UFC 3 - EA Sports
Call of Duty: WWII - The Resistance - Sledgehammer Games
Cold Iron - Catch & Release
Strikers Edge - Fun Punch Games
Dissidia: Final Fantasy NT - Team Ninja
Out of Ammo - RocketWerkz
Linelight - My Dog Zorro
Call of Duty: Infinite Warfare - Sabotage - Infinity Ward
Resident Evil 7: biohazard - Banned Footage Vol. 1 - Capcom
Pinball FX 2: Star Wars Pinball - Rogue One - Zen Studios
Dynasty Warriors: Godseekers - Omega Force
Digimon World: Next Order - B.B.Studio
Guacamelee! Super Turbo Championship Edition - DrinkBox Studios
Sniper Elite III - Rebellion
Red Faction: Guerrilla Re-Mars-tered - Volition Inc.
Lost Sea - EastAsiaSoft
'That''s You!' - Wish Studios
The Banner Saga 2 - Stoic
Furi - The Game Bakers
Romance of the Three Kingdoms XIII - Koei Tecmo Games
Carmageddon: Max Damage - Stainless Games
Arizona Sunshine - Jaywalkers Interactive
Rocket League - Psyonix, Panic Button
Skullgirls: 2nd Encore - Lab Zero Games
Pneuma: Breath of Life - Deco Digital
Accel World vs. Sword Art Online: Millennium Twilight - Artdink
Little Nightmares: The Depths - Tarsier Studios
MouseCraft - Crunching Koalas
Shining Resonance Refrain - Sega
Animal Force - Sony Interactive Entertainment
Final Fantasy XII: The Zodiac Age - Square Enix
Serial Cleaner - iFun4all, Curve Digital
MotoGP 17 - Koch Media, Milestone S.r.l
Minecraft: Story Mode Season Two - Episode 1: Hero in Residence - Telltale Games
Black The Fall - Sand Sailor Studio
Kerbal Space Program - Flying Tiger Development
Song of the Deep - Insomniac Games
Dex - Dreadlocks Ltd, Dreadlocks
Kill Strain - SCEA San Diego Studios
MilitAnt - Xibalba Studios
Ghostbusters - Activision, FireForge Games
Danger Zone 2 - Three Fields Entertainment
Earthfall - Holospark
The Vanishing of Ethan Carter - The Astronauts
God of War III Remastered - Wholesale Algorithms
Deception IV: The Nightmare Princess - Koei Tecmo Games
Rory McIlroy PGA Tour - EA Tiburon
Batman: Arkham Knight - A Matter of Family - Rocksteady Studios, WB Games Montreal
Godzilla - NATSUME ATARI Inc.
Assault Suit Leynos - Dracue
Crimsonland - 10tons Entertainment, 10tons
ADR1FT - Three One Zero
Sonic Mania Plus - Sega
Mothergunship - Grip Digital
Tempest 4000 - Llamasoft
Adventure Time: Pirates of the Enchiridion - Bandai Namco Games
Far Cry 5: Lost on Mars - Ubisoft Montreal
Children of Zodiarcs - Cardboard Utopia
Archangel - Skydance Interactive
Yonder: The Cloud Catcher Chronicles - Prideful Sloth
Fallen Legion: Sins of an Empire - YummyYummyTummy
99Vidas - QUByte Interactive
10 Second Ninja X - GameDesignDan
Neverwinter - Cryptic Studios
I Am Setsuna - Tokyo RPG Factory
Lifeless Planet: Premier Edition - Stage 2 Studios
Journey - Tricky Pixels
Game of Thrones: Episode Five - A Nest of Vipers - Telltale Games
'Q.U.B.E. Director''s Cut' - Toxic Games
Hatoful Boyfriend - Mediatonic, Hato Moa
Tembo the Badass Elephant - Game Freak
F1 2015 - Codemasters
Onechanbara Z2: Chaos - Tamsoft, D3Publisher
SUPERHOT - SUPERHOT
Fortnite - Epic Games
SUPERHOT VR - SUPERHOT
'Oddworld: Abe''s Oddysee - New ''n'' Tasty' - Just Add Water
Tour de France 2014 - Cyanide
Mega Man X Legacy Collection 1 + 2 - Capcom
The Persistence - Firesprite
The Council - Episode 3: Ripples - Big Bad Wolf
Airheart: Tales of Broken Wings - Blindflug Studios
Train Sim World - Dovetail Games
Pyre - Supergiant Games
Nioh: Defiant Honor - Team Ninja
Super Cloudbuilt - Coilworks, Double Eleven
Infinite Minigolf - Zen Studios
Aven Colony - Sold Out Software, Mothership Entertainment
Tiny Trax - FuturLab
Smashbox Arena - BigBox VR, Inc.
Remothered: Tormented Fathers - Stormind Games
Hyper Light Drifter - Heart Machine
Headlander - Double Fine Productions
Riptide GP: Renegade - Vector Unit
Chambara - team ok
Fairy Fencer F: Advent Dark Force - Compile Heart
Among the Sleep - Krillbite Studio
Theseus - Forge Reply
The Banner Saga 3 - Stoic
N++ - Metanet Software Inc.
Life is Strange: Episode 4 - Dark Room - DONTNOD Entertainment
'King''s Quest Chapter 1: A Knight to Remember' - The Odd Gentlemen
The Swindle - Size Five Games
Sword Art Online Re: Hollow Fragment - Namco Bandai Games, Bandai Namco Games, Aquria
Abyss Odyssey: Extended Dream Edition - ACE Team
Velocibox - Shawn Beck
Legend of Kay Anniversary - Neon Studios, Kaiko
Sundered - Thunder Lotus Games
The Last of Us Remastered - Naughty Dog
Rogue Legacy - Cellar Door Games
Pure Pool - VooFoo Studios
1979 Revolution: Black Friday - iNK Stories
Anamorphine - Artifact 5
The Escapists - Mouldy Toof Studios
Super Exploding Zoo - Honeyslug Ltd
Tekken 7 - Bandai Namco Games
PixelJunk Shooter Ultimate - Double Eleven
1001 Spikes - Nicalis
War Thunder - Gaijin Entertainment
Worms Battlegrounds - Team 17
Murdered: Soul Suspect - Airtight Games
Dangerous Golf - Three Fields Entertainment
BlazBlue: Cross Tag Battle - Arc System Works
The Elder Scrolls Online: Summerset - ZeniMax Media
ONRUSH - Codemasters
'Nobunaga''s Ambition: Taishi' - Koei Tecmo Games
Vampyr - DONTNOD Entertainment
The Infectious Madness of Doctor Dekker - 'D''Avekki Studios Limited'
Shaq Fu: A Legend Reborn - Big Deez Productions
Wipeout: Omega Collection - Sony Interactive Entertainment
DiRT 4 - Codemasters
The Elder Scrolls Online: Morrowind - Bethesda Softworks
ClaDun Returns: This is Sengoku! - Nippon Ichi Software
'Marvel''s Guardians of the Galaxy - Episode 2: Under Pressure' - Telltale Games
The Town of Light - LKA Interactive, LKA
Dark Rose Valkyrie - Compile Heart
Perception - The Deep End Games
Randall - We The Force
Odin Sphere Leifthrasir - Vanillaware
Guilty Gear Xrd -REVELATOR- - Arc System Works
SteamWorld Heist - Image & Form
Atelier Sophie: The Alchemist of the Mysterious Book - Gust
Fenix Furia - Green Lava Studios
'Mirror''s Edge Catalyst' - EA DICE
Anima: Gate of Memories - Edge Entertainment, Anima Project
Soul Axiom - Wales Interactive Ltd.
MotoGP 18 - Milestone S.r.l
Entwined - Pixel Opus
The Elder Scrolls Online: Tamriel Unlimited - ZeniMax Media
LEGO Jurassic World - TT Games
Unravel Two - Coldwood Interactive
Prey: Mooncrash - Arkane Studios
Jurassic World Evolution - Frontier Developments
Super Bomberman R - Konami
Trials of the Blood Dragon - RedLynx
Cars 3: Driven to Win - Avalanche Software
LEGO The Incredibles - TT Games
Payday 2: Crimewave Edition - Overkill Software
EA Sports UFC - EA Sports
Valentino Rossi The Game - Milestone, Milestone S.r.l
The Lost Child - Kadokawa
Final Fantasy XIV: Stormblood - Square Enix
Nex Machina: Death Machine - Housemarque
Dead by Daylight - 505 Games
Pac-Man 256 - HIPSTER WHALE
Grand Kingdom - Spike Chunsoft
'Deadlight: Director''s Cut' - Tequila Works
MXGP2: The Official Motocross Videogame - Milestone S.r.l
Asemblance - Nilo Studios
Mighty No. 9 - Inti Creates
Umbrella Corps - Capcom
New Gundam Breaker - Bandai Namco Games
Batman: Arkham Knight - Rocksteady Studios
Final Fantasy XIV: Heavensward - Square Enix
Tales From The Borderlands: Episode 3 - Catch A Ride - Telltale Games
PlanetSide 2 - Sony Online Entertainment, Daybreak Games
Devil May Cry 4: Special Edition - Capcom
'Shantae: Risky''s Revenge - Director''s Cut' - WayForward
'Dino Dini''s Kick Off Revival' - The Digital Lounge, Dino Dini
Get Even - The Farm 51
Resogun: Heroes - Housemarque
Valiant Hearts: The Great War - Ubisoft Montpellier
Killzone: Shadow Fall - Intercept - Guerrilla
Blue Estate - HeSaw
Transformers: Rise of the Dark Spark - Edge of Reality
N.E.R.O.: Nothing Ever Remains Obscure - Vertigo Games, Storm in a Teacup
The Awesome Adventures of Captain Spirit - DONTNOD Entertainment
Slime-san: Superslime Edition - Fabraz
Lumines Remastered - Enhance Games
The Crew 2 - Ubisoft Ivory Tower
Rainbow Skies - SideQuest Studios
Salary Man Escape VR - Sony Interactive Entertainment, Red Accent Studios
Elite: Dangerous - Frontier Developments
The Golf Club 2 - HB Studios Multimedia, Maximum Games
Danganronpa Another Episode: Ultra Despair Girls - Spike Chunsoft
Final Fantasy XV: Episode Prompto - Square Enix
Ancient Amuletor - TIGAMES
Valkyria Revolution - Media Vision
Prison Architect - Introversion, Double Eleven
LEGO Star Wars: The Force Awakens - TT Games
Heart&Slash - AHEARTFULOFGAMES
Resident Evil 5 - Capcom
Full Mojo Rampage - Over the Top Games
'Tom Clancy''s The Division - Underground' - Massive Entertainment
'JoJo''s Bizarre Adventure: Eyes of Heaven' - CyberConnect2
The Technomancer - Spiders
Star Ocean: Integrity and Faithlessness - Tri-Ace
7 Days to Die - The Fun Pimps
Tour de France 2018 - Cyanide, Cyanide Studios
God Eater Resurrection - Shift, Bandai Namco Games
BlazBlue: Chrono Phantasma Extend - Arc System Works
Whispering Willows - LOOT Interactive
J-Stars Victory Vs+ - Bandai Namco Games, Spike Chunsoft
Red Goddess: Inner World - Yanim Studio
Crash Bandicoot N. Sane Trilogy - Vicarious Visions
Micro Machines World Series - Codemasters, Just Add Water
AereA - Triangle Studios, Soedesco
Mortal Kombat XL - NetherRealm Studios
Heavy Rain - Quantic Dream, Virtuos
Screencheat - Samurai Punk
Broforce - Free Lives
The Witch and the Hundred Knight: Revival Edition - Nippon Ichi Software
Gunscape - Blowfish Studios
'Alekhine''s Gun' - Maximum Games, Bigmoon Studios
Bridge Constructor Portal - ClockStone Software
Dead or Alive 6 - Team Ninja, Koei Tecmo Games
OlliOlli2: Welcome to Olliwood - roll7
Helldivers - Arrowhead Game Studios
Resident Evil: Revelations 2 - Episode 2: Contemplation - Capcom
White Night - OSome Studio
Shiftlings - Rock Pocket Games
Zombie Army Trilogy - Rebellion
Dead Nation: Apocalypse Edition - Sony Interactive Entertainment
Awesomenauts Assemble! - Abstraction Games, Ronimo Games
Heavy Rain & Beyond: Two Souls Collection - Quantic Dream
Life is Strange: Before the Storm - Farewell - Deck Nine Games
The Occupation - White Paper Games
Left Alive - Square Enix, ilinx inc.
DJMax Respect - Rocky Studio
Final Fantasy XV: Royal Edition - Square Enix
Frantics - Sony Interactive Entertainment, NapNok Games
TT Isle of Man: Ride On The Edge - Kylotonn, Maximum Games
Scribblenauts Showdown - Warner Bros. Interactive Entertainment
Fear Effect Sedna - Sushee
Bravo Team - SuperMassive Games
NieR: Automata - PlatinumGames
Darknet - Archiact Interactive Ltd.
Atelier Firis: The Alchemist and the Mysterious Journey - Koei Tecmo Games
Disc Jam - High Horse Entertainment
Loot Rascals - Hollow Ponds
'Tom Clancy''s Ghost Recon: Wildlands' - Ubisoft Paris
LEGO Worlds - TT Games
Assault Android Cactus - Witch Beam
'Tom Clancy''s The Division' - Massive Entertainment
Action Henk - RageSquid
Kholat - IMGN.PRO
Devil May Cry 5 - Capcom
DmC: Devil May Cry Definitive Edition - Ninja Theory, QLOC
The Evil Within: The Assignment - Tango Gameworks
Resident Evil: Revelations 2 - Episode 3: Judgment - Capcom
Hotline Miami 2: Wrong Number - Dennaton
Far Cry 4: Valley of the Yetis - Ubisoft Montreal
Sniper Elite III: Ultimate Edition - Rebellion
2Dark - Gloomywood
TowerFall Ascension - Matt Thorson
Putty Squad - System 3
Hitman - Intro Pack - Io Interactive
'Tom Clancy''s The Division 2' - Massive Entertainment
The Wizards: Enhanced Edition - Carbon Studio
The Caligula Effect: Overdose - Aquria
'Assassin''s Creed Origins: The Curse of the Pharaohs' - Ubisoft Sofia
Q.U.B.E. 2 - Toxic Games
The Council - Episode 1: The Mad Ones - Big Bad Wolf
The Council - Big Bad Wolf
The Raven Remastered - THQ Nordic
Tesla vs Lovecraft - 10tons
The 25th Ward: The Silver Case - Grasshopper Manufacture
Pure Farming 2018 - Techland
Devil May Cry HD Collection - Pipeworks Software, Inc., NeoBards Entertainment
Danganronpa 1-2 Reload - Spike Chunsoft
Styx: Shards of Darkness - Cyanide
Salt and Sanctuary - Ska Studios
EA Sports UFC 2 - EA Sports
Just Cause 3: Sky Fortress - Avalanche Studios
Samurai Warriors 4 Empires - Omega Force
Sheltered - Unicube
Senran Kagura: Estival Versus - Tamsoft, Marvelous Inc.
Aegis of Earth: Protonovus Assault - Acquire
Surviving Mars - Haemimont Games
One Piece: World Seeker - Ganbarion, Bandai Namco Games
Momodora: Reverie Under the Moonlight - Bombservice
Burnout Paradise Remastered - Criterion Games, STELLAR ENTERTAINMENT SOFTWARE LTD
Tales From The Borderlands: Episode 2 - Atlas Mugged - Telltale Games
Resident Evil: Revelations 2 - Episode 4: Metamorphosis - Capcom
Resident Evil: Revelations 2 - Capcom
Battlefield Hardline - Visceral Games
Final Fantasy Type-0 HD - HexaDrive
Bladestorm: Nightmare - Omega Force
FlatOut 4: Total Insanity - Strategy First, Kylotonn
SteamWorld Dig - Image & Form
Metal Gear Solid V: Ground Zeroes - Kojima Productions
The Messenger - Sabotage Studio
Fate/Extella Link - Marvelous Inc.
Octahedron - Demimonde
Attack on Titan 2 - Omega Force
'Assassin''s Creed Rogue Remastered' - Ubisoft
Titan Quest - THQ Nordic
inFamous: Second Son - Sucker Punch
EVERYTHING - David OReilly
Toukiden 2 - Koei Tecmo Games
Mass Effect: Andromeda - BioWare
Touhou Genso Wanderer - Mediascape
Troll and I - Maximum Games
World of Warriors - Mind Candy
Day of the Tentacle Remastered - Double Fine Productions
Trackmania Turbo - Nadeo
Republique - Camouflaj, LLC
Fallout 4: Automatron - Bethesda Game Studios
Catlateral Damage - Manekoware
This Is the Police - Weappy Studio
ARK Park - Snail Games
Sekiro: Shadows Die Twice - From Software
Kona - Parabole
Ni no Kuni II: Revenant Kingdom - Level 5
A Way Out - Hazelight
Bloodborne - From Software
Borderlands: The Handsome Collection - Gearbox Software, Iron Galaxy Studios
Life is Strange: Episode 2 - Out of Time - DONTNOD Entertainment
Game of Thrones: Episode Three - The Sword in the Darkness - Telltale Games
Slender: The Arrival - Blue Isle Studios
SMITE - Hi-Rez Studios
Dead or Alive Xtreme 3: Fortune - Team Ninja
Zero Escape: The Nonary Games - Spike Chunsoft
88 Heroes - Rising Star Games, Bitmap Bureau
Fez - Polytron Corp.
Dynasty Warriors 8: Xtreme Legends Complete Edition - Omega Force
MLB The Show 19 - Sony Interactive Entertainment
The Legend of Heroes: Trails of Cold Steel - Falcom
The Walking Dead: The Telltale Series - The Final Season Episode 4: Take Us Back - Telltale Games, Skybound Games
Nelke & the Legendary Alchemists: Ateliers of the New World - Gust
Xenon Racer - 3DClouds.it
Injustice 2: Legendary Edition - NetherRealm Studios
MLB The Show 18 - Sony Interactive Entertainment
Far Cry 5 - Ubisoft Montreal
Atelier Lydie & Suelle: The Alchemists and the Mysterious Paintings - Gust
The Witch and the Hundred Knight 2 - Nippon Ichi Software
MLB The Show 17 - Sony Interactive Entertainment
Kingdom Hearts HD I.5 + II.5 Remix - Square Enix
Dark Souls III: The Ringed City - From Software
God Wars: Future Past - Kadokawa
The Walking Dead: The Telltale Series - A New Frontier Episode 3: Above the Law - Telltale Games
Snake Pass - Sumo Digital
Vikings: Wolves of Midgard - Games Farm
FATED: The Silent Oath - Frima Studio
Has-Been Heroes - Frozenbyte, Inc., GameTrust
Rain World - Videocult
MLB The Show 16 - SCEA San Diego Studios
Minecraft: Story Mode - Episode 5: Order Up! - Telltale Games
Nights of Azure - Gust
Unepic - A Crowd of Monsters
Resident Evil 6 - Capcom
Korix - StellarVR
Final Fantasy XV: Episode Gladiolus - Square Enix
Bush Hockey League - V7 Entertainment Inc.
'Assassin''s Creed III Remastered' - Ubisoft
Axiom Verge - Tom Happ
MLB 15: The Show - SCEA San Diego Studios
Toukiden: Kiwami - Koei Tecmo Games
Paperbound - Dissident Logic
Rack N Ruin - LifeSpark Entertainment
Killing Floor: Incursion - Tripwire Interactive
Guns of Icarus Alliance - Muse Games
NieR: Automata - 3C3C1D119440927 - PlatinumGames
Super Rude Bear Resurrection - Alex Rose
GNOG - KO-OP
Nioh: Dragon of the North - Team Ninja
Push Me Pull You - House House
Neverending Nightmares - Infinitap Games
Battleborn - Gearbox Software
Table Top Racing: World Tour - Playrise Edge Ltd.
The Park - Funcom
Coffin Dodgers - Milky Tea Studios
City of Brass - Uppercut Games Pty Ltd
Wolfenstein: The Old Blood - MachineGames
ETHER One - White Paper Games
Prey - Arkane Studios
Dreamfall Chapters - Red Thread Games
MLB 14: The Show - SCEA San Diego Studios
Sportsfriends - Die Gute Fabrik
Stick it to the Man! - Zoink!
Bound by Flame - Spiders
Tacoma - Fullbright
Death Road to Canada - Rocketcat Games
Megadimension Neptunia VIIR - Compile Heart
Conan Exiles - Funcom
Destiny 2: Warmind - Bungie
Trailblazers - Supergonk Ltd.
AO International Tennis - Big Ant Studios
Polybius - Llamasoft
LocoRoco - Sony Interactive Entertainment
BUTCHER - Transhuman Design, Crunching Koalas
NBA Playgrounds - Saber Interactive
Human: Fall Flat - No Brakes Games
Birthdays the Beginning - Arc System Works
'Uncharted 4: A Thief''s End' - Naughty Dog
Laser League - roll7
Final Fantasy X / X-2 HD Remaster - Virtuos
Project CARS - Slightly Mad Studios
Lost Orbit - PixelNAUTS
Nom Nom Galaxy - Q-Games
Color Guardians - Fair Play Labs
Toren - Swordtales
DOOM - id Software
'Dragon''s Crown Pro' - Vanillaware
Forgotton Anne - Throughline Games
Horizon Chase Turbo - Aquiris Game Studio
Omensight - Spearhead Games
Wizard of Legend - Contingent99
The Council - Episode 2: Hide and Seek - Big Bad Wolf
Little Witch Academia: Chamber of Time - Bandai Namco Games
Injustice 2 - NetherRealm Studios
Call of Duty: Black Ops III - Zombies Chronicles - Treyarch
The Surge - Deck 13
Farpoint - Impulse Gear
Seasons After Fall - Swing Swing Submarine
'Akiba''s Beat' - Acquire
Valkyria Chronicles Remastered - Sega
Life Goes On: Done to Death - Infinite Monkeys
Shadow of the Beast - Heavy Spectrum
Shadwen - Frozenbyte, Inc.
Homefront: The Revolution - Deep Silver Dambuster Studios
FOX n FORESTS - Bonus Level Entertainment
PixelJunk Monsters 2 - Spike Chunsoft, Q-Games
The Witcher 3: Wild Hunt - CD Projekt Red Studio
Life is Strange: Episode 3 - Chaos Theory - DONTNOD Entertainment
Destiny: House of Wolves - Bungie
Farming Simulator 15 - Giants Software
Fallout 4: Far Harbor - Bethesda Game Studios
Chroma Squad - Behold Studios
Shadow Warrior 2 - Flying Wild Hog
Skylar & Plux: Adventure on Clover Island - Grip Games, Right Nice Games
Transistor - Supergiant Games
Wolfenstein: The New Order - MachineGames
Sparkle 2 - 10tons Ltd, 10tons
EVERSPACE - ROCKFISH Games
Space Hulk: Deathwing - Streum On Studio
Tennis World Tour - Breakpoint
One Piece: Grand Cruise - Bandai Namco Games
Overwatch - Blizzard Entertainment
Samurai Warriors: Spirit of Sanada - Omega Force
Portal Knights - Keen Games
Utawarerumono: Mask of Deception - Aqua Plus
Downwell - Moppin
Lumo - Triple Eh? Ltd
Dungeons 2 - Kalypso
Teenage Mutant Ninja Turtles: Mutants in Manhattan - PlatinumGames
The Evil Within: The Executioner - Tango Gameworks
Dark Souls Remastered - From Software
Detroit: Become Human - Quantic Dream
ZEN Pinball 2: Portal Pinball - Zen Studios
Game of Thrones: Episode Four - Sons of Winter - Telltale Games
Magicka 2 - Pieces Interactive
Ultra Street Fighter IV - Other Ocean Interactive
Guilty Gear Xrd: Rev 2 - Arc System Works
RiME - Tequila Works
Friday the 13th: The Game - IllFonic, Gun Media
Watch Dogs - Ubisoft Montreal
'Yoku''s Island Express' - Villa Gorilla
Street Fighter: 30th Anniversary Collection - Capcom
Moonlighter - 11 bit studios, Digital Sun
Sega Genesis Classics - Various, D3T Limited
Agony - Madmind Studio
The Witcher 3: Wild Hunt - Blood and Wine - CD Projekt Red Studio
Ys Origin - Falcom
Victor Vran: Overkill Edition - Haemimont Games
Star Trek: Bridge Crew - Ubisoft, Red Storm Entertainment
Danger Zone - Three Fields Entertainment
Score Rush Extended - Xona Games
Oxenfree - Night School Studio
Hitman - Episode 3: Marrakesh - Io Interactive
One Piece: Burning Blood - Spike Chunsoft
Dead Island: Definitive Collection - Techland
Neon Chrome - 10tons Entertainment, 10tons
BlazBlue: Central Fiction - Arc System Works
'Earth''s Dawn' - One or Eight
Super Dungeon Bros - React Games
The Quiet Man - Square Enix, Human Head Studios
Call of Duty: Advanced Warfare - Sledgehammer Games
Need for Speed - Ghost Games
PONCHO - Delve Interactive
Call of Duty: WWII - Sledgehammer Games
.hack//G.U. Last Recode - CyberConnect2
The Binding of Isaac: Rebirth - Nicalis
MotoGP 14 - Milestone S.r.l
How to Survive: Storm Warning Edition - EKO Software
Call of Duty: Modern Warfare Remastered - Infinity Ward
Call of Duty: Infinite Warfare - Infinity Ward
Call of Duty: Black Ops III - Treyarch
The Forest - Endnight Studios
World of Final Fantasy Maxima - Square Enix
GRIP: Combat Racing - Caged Element Inc.
Deracine - From Software
Omen of Sorrow - AOne Games
Road Redemption - Dark Seas Games
Horizon Zero Dawn: The Frozen Wilds - Guerrilla
Hand of Fate 2 - Defiant Development
'Marvel''s Guardians of the Galaxy - Episode 5: Don''t Stop Believin''' - Telltale Games
Need for Speed Payback - Ghost Games
Sonic Forces - SegaSoft, Sonic Team
League of War: VR Arena - MunkyFun, Inc.
Steel Rats - Tate Multimedia
Eagle Flight - Ubisoft, FunHouse
Sword Art Online: Hollow Realization - Bandai Namco Games, Aquria
Root Letter - Kadokawa
Xenoraid - 10tons Entertainment, 10tons Ltd, 10tons
Robinson: The Journey - Crytek
Max: The Curse of Brotherhood - Wired Productions
Tetris Effect - Enhance Games
Hitman 2 - Io Interactive
11-11: Memories Retold - Digixart Entertainment
Fallout 4 - Bethesda Game Studios
Dishonored 2 - Arkane Studios
Pro Evolution Soccer 2015 - Konami
LEGO Batman 3: Beyond Gotham - TT Games
'Assassin''s Creed Unity' - Ubisoft, Ubisoft Montreal
FIFA 14 - EA Canada
Battlefield 4 - EA DICE
NBA 2K14 - Visual Concepts
'Assassin''s Creed IV: Black Flag' - Ubisoft
Injustice: Gods Among Us - Ultimate Edition - NetherRealm Studios
Madden NFL 25 - EA Sports
Warframe - Digital Extremes
Spyro Reignited Trilogy - Activision, Toys for Bob
Knowledge is Power: Decades - Wish Studios
Chimparty - NapNok Games
L.A. Noire - Team Bondi
Cat Quest - The Gentlebros
LEGO Marvel Super Heroes 2 - TT Games
Demon Gaze II - Experience Inc.
Star Wars Battlefront II - EA DICE
Outcast: Second Contact - Bigben Interactive, Bigben Games
Road Rage - Maximum Games
Fallout 76 - Bethesda Game Studios
flower - Bluepoint Games
Resogun - Housemarque, XDEV
Trine 2: Complete Story - Frozenbyte, Inc.
LEGO Marvel Super Heroes - TT Games
Need for Speed: Rivals - Ghost Games
Skylanders Swap Force - Vicarious Visions
Call of Duty: Ghosts - Infinity Ward
Killzone: Shadow Fall - Guerrilla
Super Motherload - XGenStudios
Contrast - Compulsion Games
Blacklight: Retribution - Zombie Studios
Knack - SCE Japan Studio
Watch Dogs 2 - Ubisoft Montreal
Ittle Dew 2 - Ludosity Interactive
'Assassin''s Creed: The Ezio Collection' - Ubisoft Montreal
Battlefield V - EA DICE
Killing Floor 2 - Tripwire Interactive
Ashes Cricket - Big Ant Studios
Game of Thrones: Episode Six - The Ice Dragon - Telltale Games
The Crew: Wild Run - Ivory Tower
Star Wars Battlefront - EA DICE
Game of Thrones: A Telltale Games Series - Telltale Games
Sword Art Online: Lost Song - Bandai Namco Games, Artdink
Deadpool - High Moon Studios, Iron Galaxy Studios
Yesterday Origins - Pendulo Studios
The Elder Scrolls V: Skyrim VR - Bethesda Softworks
The Sims 4 - Maxis
SG/ZH: School Girl Zombie Hunter - Tamsoft
Grand Theft Auto V - Rockstar North
Dragon Age: Inquisition - BioWare
Far Cry 4 - Ubisoft Montreal
LittleBigPlanet 3 - Sumo Digital
Never Alone - Upper One Games
MXGP: The Official Motocross Videogame - Milestone S.r.l
WWE 2K15 - 'Yuke''s'
NBA Live 14 - EA Sports
Beat Saber - Hyperbolic Magnetism
Bendy and the Ink Machine - TheMeatly Games
Squishies - Brainseed Factory
'Marvel''s Spider-Man: Turf Wars' - Insomniac Games
Farming Simulator 19 - Giants Software
Batman: The Enemy Within - Episode 3: The Fractured Mask - Telltale Games
Monster of the Deep: Final Fantasy XV - Square Enix
Planet of the Apes: Last Frontier - Creative England, Creative England
Darksiders: Warmastered Edition - Nordic Games Publishing, Kaiko
Amnesia Collection - Frictional Games
Batman: The Telltale Series - Episode 4: Guardian of Gotham - Telltale Games
Bloodborne: The Old Hunters - From Software
Minecraft: Story Mode - Episode 3: The Last Place You Look - Telltale Games
Beyond: Two Souls - Quantic Dream
Geometry Wars 3: Dimensions - Lucid Games
Tales From The Borderlands: Episode 1 - Zer0 Sum - Telltale Games
'Akiba''s Trip: Undead & Undressed' - Acquire
Darksiders III - Gunfire Games, THQ Nordic
Sky Force Reloaded - Infinite Dreams Inc.
Star Ocean 4: The Last Hope - 4K & Full HD Remaster - Square Enix, Tri-Ace
'It''s Quiz Time' - Vision Games Publishing LTD
Black Mirror - THQ Nordic
Final Fantasy XV - Square Enix
Pinball FX2 VR - Zen Studios
How We Soar - Penny Black Studios
Crystal Rift - Psytec Games Ltd
RIDE 3 - MileStone Inc., Milestone S.r.l
Astro Bot: Rescue Mission - JapanStudio
'Assassin''s Creed Odyssey' - Ubisoft
Mega Man 11 - Capcom
Fist of the North Star: Lost Paradise - Ryu ga Gotoku Studios
Detention - Red Candle Game
'Dragon''s Dogma: Dark Arisen' - Capcom
JYDGE - 10tons
Battle Chasers: Nightwar - Airship Syndicate Entertainment
Shu - Coatsink Software
Warhammer: End Times - Vermintide - Fatshark AB
Dead Synchronicity: Tomorrow Comes Today - Fictiorama Studios
'A Bastard''s Tale' - No Pest Productions
Skylanders Trap Team - Toys for Bob
WWE 2K19 - 'Yuke''s, Visual Concepts'
Super Meat Boy - Team Meat
Disgaea 5: Alliance of Vengeance - Nippon Ichi Software
Rock Band 4 - Harmonix Music Systems
Transformers: Devastation - PlatinumGames
Metal Gear Solid V: Metal Gear Online - Kojima Productions
RIDE - Milestone S.r.l
'Saint Seiya: Soldiers'' Soul' - Dimps Corporation
NBA 2K15 - Visual Concepts
Pix the Cat - Pasta Games
Alien: Isolation - Creative Assembly
Driveclub - Evolution Studios
Styx: Master of Shadows - Cyanide
Mafia III - Hangar 13
WRC 6: World Rally Championship - Kylotonn
Uncharted: The Nathan Drake Collection - Bluepoint Games
Disgaea 1 Complete - Nippon Ichi Software
My Memory of Us - Juggler Games
Punch Line - 5pb
Thumper - drool Games, Drool
Wayward Sky - Uber Entertainment
Aragami - Lince Works
Tumble VR - SuperMassive Games
Super Stardust Ultra VR - Sony Interactive Entertainment
PlayStation VR WORLDS - SCEE London Studio, Sony Interactive Entertainment
Harmonix Music VR - Harmonix Music Systems
Middle-earth: Shadow of War - Monolith Productions
ECHO - Ultra Ultra
'Raiden V: Director''s Cut' - Moss
Cyberdimension Neptunia: 4 Goddesses Online - Compile Heart
'Marvel''s Guardians of the Galaxy - Episode 4: Who Needs You' - Telltale Games
Raid: World War II - Starbreeze
Touhou Kobuto V: Burst Battle - CUBETYPE
Rise of the Tomb Raider: 20 Year Celebration - Crystal Dynamics, Nixxes Software
Dragon Quest Builders - Square Enix
Duke Nukem 3D: 20th Anniversary World Tour - Gearbox Software
Reus - Soedesco
Batman: Arkham VR - Rocksteady Studios
WWE 2K17 - 'Yuke''s'
The Witcher 3: Wild Hunt - Hearts of Stone - CD Projekt Red Studio
Mantis Burn Racing - VooFoo Studios
Call of Duty: Black Ops 4 - Treyarch
The Talos Principle - Croteam
'Wasteland 2: Director''s Cut' - InXile Entertainment
'Dragon Quest Heroes: The World Tree''s Woe and the Blight Below' - Omega Force
Minecraft: Story Mode - Episode 1: The Order of the Stone - Telltale Games
Grand Ages: Medieval - Gaming Minds Studios
WRC 5 - Kylotonn, Milestone S.r.l
Bedlam: The Game by Christopher Brookmyre - Standfast Interactive
Rez Infinite - Q Entertainment, Monstars Inc., Enhance Games
Keep Talking and Nobody Explodes - Steel Crate Games
RIGS: Mechanized Combat League - Guerilla Cambridge
SuperHyperCube - KOKOROMI
Headmaster - Frame Interactive
Until Dawn: Rush of Blood - SuperMassive Games
Job Simulator - Owlchemy Labs
EVE: Valkyrie - CCP
Battlezone - Rebellion
Here They Lie - The Tangentlemen
EVE: Gunjack - CCP
The Assembly - nDreams
Loading Human: Chapter 1 - Untold Games
Ace Banana - TVR
The Evil Within 2 - Tango Gameworks
WWE 2K18 - 'Yuke''s'
ZEN Pinball 2: South Park: Super-Sweet Pinball - Zen Studios
Sleeping Dogs: Definitive Edition - United Front Games
The Evil Within - Tango Gameworks
In Space We Brawl - Forge Reply
The Missing: JJ Macfield and the Island of Memories - White Owls
Kromaia Omega - Kraken Empire
Skylanders Imaginators - Toys for Bob
For Honor: Marching Fire - Ubisoft
LEGO DC Super-Villains - TT Games
NBA 2K Playgrounds 2 - Saber Interactive
Warriors Orochi 4 - Omega Force
Starlink: Battle for Atlas - Ubisoft Toronto
Home Sweet Home - Mastiff
Heavy Fire: Red Shadow - Mastiff
South Park: The Fractured But Whole - Ubisoft San Francisco
Gran Turismo Sport - Polyphony Digital
Megaton Rainfall - Pentadimensional Games
Rogue Trooper Redux - Sold Out
Elex - Piranha Bytes
Battlefield 1 - EA DICE
Batman: Return to Arkham - Rocksteady Studios, Virtuos
LEGO Harry Potter Collection - Warner Bros. Interactive Entertainment
Mordheim: City of the Damned - Rogue Factor
Exist Archive: The Other Side of the Sky - Tri-Ace
SportsBarVR - Cherry Pop Games, Perilous Orbit
Sinner: Sacrifice for Redemption - DarkStar Games
Life is Strange: Before the Storm - Episode 2: Brave New World - Deck Nine Games
SoulCalibur VI - Bandai Namco Games, Project Soul
Tales From The Borderlands: Episode 5 - The Vault of the Traveler - Telltale Games
Tales from the Borderlands: A Telltale Game Series - Telltale Games
Life is Strange - DONTNOD Entertainment
Life is Strange: Episode 5 - Polarized - DONTNOD Entertainment
Guitar Hero Live - FreeStyleGames
ZEN Pinball 2: Balls of Glory - Zen Studios
Just Dance 2016 - Ubisoft
Tales of Zestiria - Bandai Namco Games
Primal Carnage: Extinction - Lukewarm Media, Circle 5, Circle 5 Studios
Pixel Gear - Geronimo Interactive
Race the Sun - Flippfly
Samurai Warriors 4 - Omega Force
Just Dance 2015 - Ubisoft
Shadow Warrior - Flying Wild Hog
The Legend of Korra - PlatinumGames
Fluster Cluck - LOOT Entertainment
'Assassin''s Creed Syndicate' - Ubisoft Quebec
'Marvel''s Spider-Man: The Heist' - Insomniac Games
Nickelodeon Kart Racers - GameMill Entertainment
SingStar: Ultimate Party - SCEE
Yomawari: Midnight Shadows - Nippon Ichi Software
The Mummy Demastered - WayForward
Just Dance 2018 - Ubisoft Paris
Knowledge is Power - Sony Interactive Entertainment, Wish Studios
Nights of Azure 2: Bride of the New Moon - Gust
Hidden Agenda - SuperMassive Games
Rugby 18 - Koch Media
'King''s Quest Chapter 5: The Good Knight' - The Odd Gentlemen
World of Final Fantasy - Square Enix
Tethered - Secret Sorcery, SECRET SORCERY LIMITED, Secret Sorcery Towers
'Nobunaga''s Ambition: Sphere of Influence - Ascension' - Koei Tecmo Games
Batman: The Telltale Series - Episode 3: New World Order - Telltale Games
Just Dance 2017 - Ubisoft Paris
Dragon Ball: Xenoverse 2 - Dimps Corporation
Dark Souls III: Ashes of Ariandel - From Software
'Sherlock Holmes: The Devil''s Daughter' - Frogwares
Farming Simulator 17 - Maximum Games
Windlands - Psytec Games Ltd
'Exile''s End' - MagneticRealms
Mark McMorris Infinite Air - HB Studios Multimedia
AER: Memories of Old - Daedalic Entertainment
Red Dead Redemption 2 - Rockstar Games
Castlevania Requiem: Symphony of the Night & Rondo of Blood - Konami
'My Hero One''s Justice' - Bandai Namco Games
Divinity: Original Sin Enhanced Edition - Larian Studios Games Ltd
Driveclub Bikes - Evolution Studios
WWE 2K16 - 'Yuke''s'
Minecraft: Story Mode - Episode 2: Assembly Required - Telltale Games
MX vs. ATV Supercross Encore - Rainbow Studios
Weeping Doll - TianShe Media
Wolfenstein II: The New Colossus - MachineGames
'Assassin''s Creed Origins' - Ubisoft, Ubisoft Montreal
Costume Quest 2 - Double Fine Productions
Lords of the Fallen - City Interactive, Deck 13
NBA Live 15 - EA Sports
Titanfall 2 - Respawn Entertainment
The Elder Scrolls V: Skyrim Special Edition - Bethesda Game Studios
Carnival Games VR - Cat Daddy Games
Darksiders II: Deathinitive Edition - Gunfire Games
Oure - Heavy Spectrum
Call of Cthulhu - Cyanide, Cyanide Studios
Hitman - Io Interactive
Hitman - Episode 6: Hokkaido - Io Interactive
Summon Night 6: Lost Borders - Media Vision
Spintires: Mudrunner - Koch Media
Stifled - Gattai Games
Bubsy: The Woolies Strike Back - Black Forest Games
Metal Gear Solid V: The Phantom Pain - Kojima Productions, Moby Dick Studio
'Nobunaga''s Ambition: Sphere of Influence' - Koei Tecmo Games
Xeodrifter - Renegade Kid
Grow Home - Ubisoft Reflections
Armello - League of Geeks
Mad Max - Avalanche Studios
Zombie Vikings - Zoink!
Rabi-Ribi - CreSpirit
Velocity 2X - FuturLab
Warriors Orochi 3 Ultimate - Omega Force
Minecraft: PlayStation 4 Edition - 4J Studios, Mojang AB
Dragon Quest XI: Echoes of an Elusive Age - Square Enix
428: Shibuya Scramble - Spike Chunsoft
Destiny 2: Forsaken - Bungie Software, Bungie
Shadows: Awakening - Kalypso
Zone of the Enders: The 2nd Runner MARS - Cygames
Planet Alpha - Adrian Lazar
Utawarerumono: Mask of Truth - Aqua Plus
Songbringer - Wizard Fu Games
Knack 2 - SCE Japan Studio
'Don''t Knock Twice' - Wales Interactive Ltd.
Touhou Genso Rondo: Bullet Ballet - Mediascape, CUBETYPE
The Tomorrow Children - Q-Games
Destiny 2 - Bungie
Oceanhorn: Monster of Uncharted Seas - Cornfox & Bros.
'Marvel''s Spider-Man' - Insomniac Games
NBA 2K19 - Visual Concepts
NBA Live 19 - EA Sports, EA Tiburon
NASCAR Heat 3 - Monster Games Inc., 704Games
SNK Heroines: Tag Team Frenzy - SNK Corporation
Immortal: Unchained - Toadman Interactive
Tearaway Unfolded - Media Molecule
'Broken Sword 5: The Serpent''s Curse' - Revolution Software
Beyond Eyes - tiger & squid
Destiny - Bungie Software, Bungie
NHL 15 - EA Sports
Jotun: Valhalla Edition - Thunder Lotus Games
V-Rally 4 - Kylotonn
Ys VIII: Lacrimosa of DANA - Falcom
Pro Evolution Soccer 2018 - Konami
NHL 18 - EA Sports
'Ken Follett''s The Pillars of the Earth' - Kalypso
Senran Kagura: Peach Beach Splash - Tamsoft, Marvelous Inc.
NASCAR Heat 2 - Monster Games Inc., 704Games
Shadow of the Tomb Raider - Eidos Montreal
Pro Evolution Soccer 2017 - Konami
BioShock: The Collection - 2K Games
NHL 17 - EA Canada, EA Vancouver
Pac-Man Championship Edition 2 - Bandai Namco Games
RIVE - Two Tribes
Psycho-Pass: Mandatory Happiness - 5pb
Dead Rising Triple Pack - Capcom
Batman: The Telltale Series - Telltale Games
Mount & Blade: Warband - Koch Media, Taleworlds
NASCAR Heat Evolution - Monster Games Inc., Dusenberry Martin Racing
Baja: Edge of Control HD - THQ Nordic
NHL 19 - EA Sports
Black Clover: Quartet Knights - Bandai Namco Games, ilinx inc.
Pro Evolution Soccer 2016 - Konami
Destiny: The Taken King - 
NHL 16 - EA Sports, EA Canada
Dishonored: Death of the Outsider - Arkane Studios
NBA 2K18 - Visual Concepts
Nidhogg 2 - Messhof
NBA Live 18 - EA Sports
WRC 7 - Kylotonn
Anomaly 2 - 11 bit studios
KickBeat: Special Edition - Zen Studios
Air Conflicts: Vietnam Ultimate Edition - bitComposer Entertainment AG, bitComposer
NBA 2K17 - Visual Concepts
Filthy Lucre - Fabrik Games
The Book of Unwritten Tales 2 - KING Art
The Solus Project - Grip Games
Labyrinth of Refrain: Coven of Dusk - Nippon Ichi Software
'Capcom Beat ''Em Up Bundle' - Capcom
Transference - SpectreVision
Blind - Tiny Bull Studios
Downward Spiral: Horus Station - 3rd Eye Studios Oy LTD, 3rd Eye Studios
Final Fantasy IX - SquareSoft, Square Enix
Marvel vs. Capcom: Infinite - Capcom
Hidden Dragon Legend - Oasis Games
Skylanders SuperChargers - Vicarious Visions
Destiny: Rise of Iron - Bungie
The Bunker - Splendy Games
Dear Esther: Landmark Edition - The Chinese Room
Slain: Back from Hell - Wolf Brew Games
Batman: The Telltale Series - Episode 2: Children of Arkham - Telltale Games
Zenith - Infinigon
The Gardens Between - The Voxel Agents
Driveclub VR - Evolution Studios
FIFA 16 - EA Sports
SOMA - Frictional Games
Blood Bowl 2 - Cyanide
Penarium - Self Made Miracle
Afro Samurai 2: Revenge of Kuma Volume One - Versus Evil
Virginia - 505 Games
Touhou: Scarlet Curiosity - Mediascape
Project CARS 2 - Bandai Namco Games, Slightly Mad Studios
The LEGO NINJAGO Movie Video Game - TT Games
Raiders of the Broken Planet - Mercury Steam
FIFA 15 - EA Sports
DG2: Defense Grid 2 - Hidden Path Entertainment
CastleStorm: Definitive Edition - Zen Studios
Disney Infinity 2.0 Edition - Avalanche Software
Flockers - Team 17
NBA 2K16 - Visual Concepts
Valkyria Chronicles 4 - Sega, Media Vision
FIFA 19 - EA Sports
Timespinner - Lunar Ray Games
Creed: Rise to Glory - Survios
The Council - Episode 4: Burning Bridges - Big Bad Wolf
The Walking Dead: The Telltale Series - The Final Season Episode 2: Suffer the Children - Telltale Games
Dark Eclipse - SunSoft
Metal Max Xeno - Cattle Call, 24Frame
Dakar 18 - Bigmoon Entertainment
'Nioh: Bloodshed''s End' - Team Ninja
FIFA 18 - EA Vancouver
Danganronpa V3: Killing Harmony - Spike Chunsoft
Hob - Runic Games
Pinball FX3 - Zen Studios
Ruiner - Reikon Games
Light Tracer - Oasis Games
Batman: The Enemy Within - Episode 2: The Pact - Telltale Games
DreamWorks Voltron VR Chronicles - Digital Domain
Blue Reflection - Gust
LEGO Dimensions - 'Traveller''s Tales'
XCOM 2 - Firaxis Games
FIFA 17 - EA Sports, EA Vancouver
Darkest Dungeon - Red Hook Studios
Deus Ex: Mankind Divided - System Rift - Eidos Montreal
Hitman - Episode 5: Colorado - Io Interactive
Lichtspeer - Lichthund
'King''s Quest Chapter 4: Snow Place Like Home' - The Odd Gentlemen
100ft Robot Golf - No Goblin
Life is Strange 2: Episode 1 - Roads - DONTNOD Entertainment
Samurai Warriors 4-II - Omega Force
NBA Live 16 - EA Sports
'Tony Hawk''s Pro Skater 5' - Robomodo
Gundam Versus - Bandai Namco Games
Middle-earth: Shadow of Mordor - Monolith Productions
Chariot - Frima Studio
Watch Dogs: Bad Blood - Ubisoft Montreal
Sherlock Holmes: Crimes & Punishments - Frogwares
Futuridium EP Deluxe - MixedBag Srl
Natural Doctrine - Kadokawa
