Steredenn - Pixelnest Studio
Call of Duty: Ghosts - Devastation - Infinity Ward
Stealth Inc 2: A Game of Clones - Curve Digital
The Adventure Pals - Massive Monster
Minit - JW, Kitty, Jukio, and Dom
LEGO City Undercover - TT Games
DiRT Rally - Codemasters
Quantum Break - Remedy Entertainment
Enter The Gungeon - Dodge Roll
Blackwood Crossing - PaperSeven
Dark Souls II: Scholar of the First Sin - From Software
Bulletstorm: Full Clip Edition - People Can Fly
LEGO The Hobbit - TT Games
'Strike Suit Zero: Director''s Cut' - Born Ready Games
Kinect Sports Rivals - Microsoft Game Studios
'Letter Quest: Grimm''s Journey Remastered' - Bacon Bandit Games
Blues and Bullets - Episode 2: Shaking The Hive - A Crowd of Monsters
Enigmatis: The Ghosts of Maple Creek - Artifex Mundi
Tower of Guns - Terrible Posture Games
Owlboy - BlitWorks
Extinction - Iron Galaxy Studios
The Sexy Brutale - Abstraction Games, Tequila Works, Cavalier Game Studios
Aaero - Mad Fellows Ltd
Crawl - Powerhoof
Yooka-Laylee - Playtonic Games
'Hellblade: Senua''s Sacrifice' - Ninja Theory
Ys Origin - Falcom
Robocraft Infinity - Freejam
Dark Souls III - From Software
Mortal Kombat X - Warner Bros. Interactive Entertainment, NetherRealm Studios
Soda Drinker Pro - Snowrunner Games
Trials Fusion - RedLynx
Goat Simulator - Coffee Stain Studios
'Wonder Boy: The Dragon''s Trap' - Lizardcube
The Disney Afternoon Collection - Capcom
'Marvel''s Guardians of the Galaxy - Episode 1: Tangled Up in Blue' - Telltale Games
Late Shift - Wales Interactive Ltd.
Voodoo Vince Remastered - 
Shiness: The Lightning Kingdom - Enigami
Shovel Knight - Yacht Club Games
'Assassin''s Creed Chronicles: China' - Ubisoft, Climax Studios
Cities: Skylines - Xbox One Edition - Tantalus
Outlast 2 - Red Barrels
Sniper: Ghost Warrior 3 - City Interactive
'King''s Quest Chapter 3: Once Upon a Climb' - The Odd Gentlemen
Hitman - Episode 2: Sapienza - Io Interactive
Party Hard - Pinokl Games
State of Decay: Year One Survival Edition - Undead Labs
Little Nightmares - Tarsier Studios
The Amazing Spider-Man 2 - Beenox
Project Root - Pablo Testa
Paranautical Activity - Code Avarice
Child of Light - Ubisoft Montreal
The Long Dark - Hinterland
Batman: The Telltale Series - Episode 1: Realm of Shadows - Telltale Games
Battleship - Frima Studio
Tacoma - The Fullbright Company, Fullbright
Overcooked! - Ghost Town Games Ltd.
Rare Replay - Rare Ltd., Code Mystics Inc.
Call of Duty: Advanced Warfare - Reckoning - Sledgehammer Games
Beyond Eyes - tiger & squid
Submerged - Uppercut Games Pty Ltd
Dead Cells - Motion Twin
Overcooked! 2 - Ghost Town Games Ltd.
Batman: The Enemy Within - Episode 1: The Enigma - Telltale Games
Madden NFL 19 - EA Tiburon
We Happy Few - Compulsion Games
Toy Soldiers: War Chest - Krome Studios
Super Mega Baseball: Extra Innings - Metalhead Software
The Walking Dead: The Telltale Series - The Final Season Episode 1: Done Running - Telltale Games
Observer - Bloober Team
Sonic Mania - SegaSoft, Sega, PagodaWest Games
'Ken Follett''s The Pillars of the Earth' - Kalypso
Agents of Mayhem - Volition Inc.
State of Mind - Daedalic Entertainment
Graveyard Keeper - Lazy Bear Games
Grow Up - Ubisoft Reflections
Uno - Ubisoft Chengdu
Zombi - Ubisoft Montpellier, Straight Right
Thumper - drool Games, Drool
Diablo III: Ultimate Evil Edition - Blizzard Entertainment
The Golf Club - HB Studios Multimedia
SMITE - Hi-Rez Studios
Giana Sisters: Dream Runners - Black Forest Games
F1 2016 - Codemasters
Bridge Constructor - ClockStone Software
Shenmue I & II - Sega, d3t Ltd
Brawlout - Angry Mob Games
Madden NFL 18 - EA Sports
The Escapists 2 - Mouldy Toof Studios
'Marvel''s Guardians of the Galaxy - Episode 3: More Than A Feeling' - Telltale Games
Madden NFL 17 - EA Sports
Deus Ex: Mankind Divided - Eidos Montreal
Worms W.M.D - Team 17
Valley - Blue Isle Studios
Armikrog - Versus Evil, Pencil Test Studios
Path of Exile: The Fall of Oriath - Grinding Gear Games
F1 2018 - Codemasters
Madden NFL 16 - EA Sports
Gears of War: Ultimate Edition - Splash Damage, The Coalition
Mega Man Legacy Collection - Digital Eclipse
Dishonored: Definitive Edition - Arkane Studios
F1 2017 - Codemasters
Metro Redux - 4A Games
Madden NFL 15 - EA Sports
Blues and Bullets - Episode 1: The End of Peace - A Crowd of Monsters
Pro Evolution Soccer 2019 - Konami
The Golf Club 2019 featuring PGA Tour - HB Studios Multimedia
Strange Brigade - Rebellion
Pillars of Eternity: Complete Edition - Obsidian Entertainment, Paradox Arctic
Killing Floor 2 - Tripwire Interactive
Redout - 34BigThings
Dead Alliance - IllFonic, Maximum Games, Psyop
Disney Infinity 3.0 Edition - Avalanche Software
The Turing Test - Bulkhead Interactive
Hue - Fiddlesticks Games
Livelock - Tuque Games
Attack on Titan - Omega Force
Resident Evil 4 - Capcom
Assetto Corsa - Kunos Simulazioni
Life is Strange: Before the Storm - Episode 1: Awake - Deck Nine Games
Divinity: Original Sin II - Definitive Edition - Larian Studios Games Ltd
Naruto to Boruto: Shinobi Striker - CyberConnect2
'Tom Clancy''s Rainbow Six Siege' - Ubisoft Montreal
Just Cause 3 - Avalanche Studios
The Incredible Adventures of Van Helsing - NeocoreGames
The Dwarves - Nordic Games Publishing
Sky Force Reloaded - Infinite Dreams Inc.
SOMA - Frictional Games
Hand of Fate 2 - Defiant Development
The Crew - Ubisoft Reflections, Ivory Tower
Chivalry: Medieval Warfare - Torn Banner Studios, Hardsuit Labs
Furi - The Game Bakers
Steep - Ubisoft Annecy
Game of Thrones: Episode One - Iron From Ice - Telltale Games
Thronebreaker: The Witcher Tales - CD Projekt Red Studio
Monster Boy and the Cursed Kingdom - FDG Entertainment
Subnautica - Unknown Worlds Entertainment
Mutant Year Zero: Road to Eden - The Bearded Ladies Consulting
Just Cause 4 - Avalanche Studios
Override: Mech City Brawl - Modus
Destiny 2: Curse of Osiris - Bungie
Dead Rising 4 - Capcom, Capcom Vancouver
A Hat in Time - Gears for Breakfast
Battle Princess Madelyn - Causal Bit Games
'Her Majesty''s SPIFFING' - BillyGoat Entertainment Ltd
Ashen - A44
Hello Neighbor - tinyBuild
Peggle 2 - PopCap
Lara Croft and the Temple of Osiris - Crystal Dynamics
Sky Force Anniversary - Infinite Dreams Inc.
Starpoint Gemini 2 - Little Green Men
Okami HD - Capcom
Forza Horizon 3: Blizzard Mountain - Playground Games
Batman: The Telltale Series - Episode 5: City of Light - Telltale Games
The Little Acre - Curve Digital Games, Curve Digital
Stardew Valley - Sickhead Games, LLC, Eric Barone
Below - Capy Games
'King''s Quest Chapter 2: Rubble Without a Cause' - The Odd Gentlemen
Forza Horizon 2: Storm Island - Playground Games
Tetris Ultimate - Ubisoft, Ubisoft San Francisco
'Assassin''s Creed IV: Black Flag - Freedom Cry' - Ubisoft Montreal
Kalimba - Press Play
Max: The Curse of Brotherhood - Press Play
The Walking Dead: The Telltale Series - A New Frontier Episode 2: Ties That Bind Part Two - Telltale Games
The Walking Dead: The Telltale Series - A New Frontier Episode 1: Ties That Bind Part One - Telltale Games
Life is Strange: Before the Storm - Episode 3: Hell is Empty - Deck Nine Games
Minecraft: Story Mode - Episode 4: A Block and a Hard Place - Telltale Games
Halo: Spartan Assault - Vanguard, 343 Industries
Sunset Overdrive and the Mystery of the Mooil Rig! - Insomniac Games
World of Van Helsing: Deathtrap - NeocoreGames
Candleman - Spotlightor Interactive
Wargroove - Chucklefish
Cobalt - Oxeye
Fortified - Clapfoot Inc.
Naruto Shippuden: Ultimate Ninja Storm 4 - Road to Boruto Expansion - CyberConnect2
Game of Thrones: Episode Two - The Lost Lords - Telltale Games
Apex Legends - Respawn Entertainment
The LEGO Movie Videogame - TT Games
Dying Light: The Following - Techland
Naruto Shippuden: Ultimate Ninja Storm 4 - CyberConnect2
Unravel - Coldwood Interactive
'Assassin''s Creed Chronicles: Russia' - Ubisoft, Climax Studios
Evolve - Turtle Rock Studios
Factotum 90 - TACS Games
Uncanny Valley - Digerati Distribution
Dead Rising 3: Fallen Angel - Capcom Vancouver
Q*bert: Rebooted: The XBOX One @!#?@! Edition - GPC Games
The Escapists - Mouldy Toof Studios
Monster Energy Supercross: The Official Videogame - Milestone S.r.l
Kingdom Come: Deliverance - Warhorse Studios
Dynasty Warriors 9 - Omega Force, Koei Tecmo Games
Sniper Elite 4 - Rebellion
For Honor - Ubisoft Montreal
Ride 2 - Milestone S.r.l
Metro Exodus - 4A Games
Far Cry New Dawn - Ubisoft Montreal
Jump Force - Spike Chunsoft Co. Ltd., Spike Chunsoft
Crackdown 3 - Sumo Digital, Elbow Rocket
Layers of Fear - Bloober Team
Pixel Piracy - Abstraction Games
Fe - Zoink!
Dead or Alive 5: Last Round - Team Ninja
Rocket League - Psyonix, Panic Button
Halo Wars 2 - Creative Assembly
Hand of Fate - Defiant Development
Strider - Double Helix Games
Roundabout - No Goblin
The Station - The Station
Metal Gear Survive - Konami
Dead Rising 3: Chaos Rising - Capcom Vancouver
Halo Wars: Definitive Edition - Microsoft Game Studios, Microsoft
Rad Rodgers - Slipgate Studios LLC
Fable Fortune - Mediatonic
Anthem - BioWare
Plants vs Zombies: Garden Warfare 2 - PopCap
Far Cry Primal - Ubisoft Montreal
'Agatha Christie''s The ABC Murders' - Microids
The Walking Dead: Michonne - Episode 1: In Too Deep - Skybound LLC
Sword Art Online: Fatal Bullet - Dimps Corporation
Past Cure - Phantom 8
Dragon Ball: Xenoverse - Dimps Corporation
Dynasty Warriors 8 Empires - Koei Tecmo Games
The Flame in the Flood - The Molasses Flood
Chime Sharp - Chilled Mouse
Plants vs Zombies: Garden Warfare - PopCap
Thief - Eidos Montreal
Resident Evil: Revelations 2 - Episode 1: Penal Colony - Capcom
Tiny Troopers: Joint Ops - Kukouri Mobile Entertainment, Epiphany Games
Trials Rising - RedLynx
DiRT Rally 2.0 - Codemasters
The LEGO Movie 2 Videogame - TT Games
Pneuma: Breath of Life - Deco Digital
Immortal Redneck - CremaGames, Crema Games
de Blob 2 - Blue Tongue Entertainment
Gravel - Milestone S.r.l
Torment: Tides of Numenera - InXile Entertainment
Ghost Blade HD - HUCAST
Bridge Constructor Portal - ClockStone Software
Lovely Planet - QUICKTEQUILA
Funk of Titans - A Crowd of Monsters
Aftercharge - Chainsawesome Games
Nevermind - Flying Mollusk
Tales of Vesperia: Definitive Edition - Bandai Namco Games
The Banner Saga - Stoic
'Assassin''s Creed Chronicles: India' - Ubisoft, Climax Studios
'Assassin''s Creed Unity: Dead Kings' - Ubisoft, Ubisoft Montreal
Dead Effect 2 - BadFly Interactive, a.s, BadFly Interactive
Oxenfree - Night School Studio
ZHEROS - Rimlight Studios
Onimusha: Warlords - Capcom, NeoBards Entertainment
InnerSpace - PolyKnight Games
RWBY: Grimm Eclipse - Rooster Teeth Games
Full Metal Furies - Cellar Door Games
Guacamelee! 2 - DrinkBox Studios
Ace Combat 7: Skies Unknown - Bandai Namco Games
Resident Evil 0: HD Remaster - Capcom
Gemini: Heroes Reborn - Phosphor Games
The Vanishing of Ethan Carter - The Astronauts
Resident Evil HD Remaster - Capcom
Saints Row IV: Re-Elected - Volition Inc.
Saints Row: Gat Out of Hell - Volition Inc.
Toby: The Secret Mine - Headup Games
I Am Bread - Bossa Studios
Dead Rising 3: Operation Broken Eagle - 
Unruly Heroes - Magic Design Studios
Resident Evil 7: biohazard - Capcom
Life is Strange 2: Episode 2 - Rules - DONTNOD Entertainment
TowerFall Ascension - Matt Makes Games Inc.
Resident Evil 2 - Capcom R&D Division 1
Rise of the Tomb Raider: Baba Yaga - The Temple of the Witch - Crystal Dynamics, Nixxes Software
'LEGO Marvel''s Avengers' - TT Games
Celeste - Matt Makes Games Inc.
Monster Hunter: World - Capcom
Dragon Ball FighterZ - Arc System Works
Dying Light - Techland
Call of Duty: Advanced Warfare - Havoc - Sledgehammer Games
Tomb Raider: Definitive Edition - Crystal Dynamics, United Front Games
Call of Duty: Ghosts - Onslaught - Infinity Ward
This War of Mine: The Little Ones - 11 bit studios
'LEVEL 22, Gary''s Misadventures' - Moving Player, Noego
Sebastien Loeb Rally Evo - Milestone S.r.l
Kingdom Hearts III - Square Enix
Genesis Alpha One - Radiation Blue
#IDARB - Other Ocean Interactive
Life is Strange: Episode 1 - Chrysalis - DONTNOD Entertainment
Unmechanical: Extended Edition - Grip Games
Railway Empire - Gaming Minds Studios
EA Sports UFC 3 - EA Sports
Wulverblade - Darkwind Media
Sniper Elite III - Rebellion
The Banner Saga 2 - Stoic Jester Studios, Stoic
Prison Architect - Introversion, Double Eleven
The Incredible Adventures of Van Helsing II - NeocoreGames
Guacamelee! Super Turbo Championship Edition - DrinkBox Studios
Red Faction: Guerrilla Re-Mars-tered - Volition Inc.
Carmageddon: Max Damage - Stainless Games
Warhammer 40,000: Inquisitor - Martyr - Maximum Games
Spectra: 8bit Racing - Gateway Interactive
MXGP Pro - Milestone S.r.l
Bomber Crew - Runner Duck
Danger Zone 2 - Three Fields Entertainment
Minecraft: Story Mode Season Two - Episode 1: Hero in Residence - Telltale Games
Black The Fall - Sand Sailor Studio
Warhammer: Vermintide 2 - Fatshark AB
Anarcute - Anarteam
Song of the Deep - Insomniac Games
Ghostbusters - Activision
FRU - Through Games
The Spectrum Retreat - Dan Smith Studios
Earthfall - Holospark
Batman: Arkham Knight - A Matter of Family - WB Games Montreal
Rory McIlroy PGA Tour - EA Tiburon
Serial Cleaner - iFun4all, Curve Digital
Tachyon Project - Eclipse Games
Kerbal Space Program - Flying Tiger Entertainment Inc., Squad
Tumblestone - Ty Taylor and Mario Castaneda
No Time to Explain - tiny Build GAMES, tinyBuild
Mothergunship - Grip Digital
Tempest 4000 - Llamasoft
10 Second Ninja X - GameDesignDan
What Remains of Edith Finch - Giant Sparrow
Maldita Castilla EX: Cursed Castilla - Locomalito
Gigantic - Motiga
Tembo the Badass Elephant - Game Freak
F1 2015 - Codemasters
Game of Thrones: Episode Five - A Nest of Vipers - Telltale Games
'Q.U.B.E. Director''s Cut' - Toxic Games
'No Man''s Sky' - Hello Games
Aven Colony - Sold Out, Mothership Entertainment
Remothered: Tormented Fathers - Stormind Games
Hyper Light Drifter - Heart Machine
The Banner Saga 3 - Stoic
World of Tanks - Wargaming.net
Life is Strange: Episode 4 - Dark Room - DONTNOD Entertainment
Super Cloudbuilt - Coilworks, Double Eleven
'King''s Quest Chapter 1: A Knight to Remember' - The Odd Gentlemen
Gene Rain - Deeli network
Massive Chalice - Double Fine Productions
Fragments of Him - Sassybot
TurnOn - Brainy Studio LLC
Earth Atlantis - Pixel Perfex
Call of Duty: Advanced Warfare - Supremacy - 
Tekken 7 - Bandai Namco Games
Murdered: Soul Suspect - Airtight Games
Sparkle Unleashed - 10tons Entertainment, 10tons
Anima: Gate of Memories - Anima Project
Hard Reset Redux - Flying Wild Hog
Dangerous Golf - Three Fields Entertainment
SteamWorld Dig - Image & Form
Aragami: Shadow Edition - Lince Works
ONRUSH - Codemasters
Vampyr - DONTNOD Entertainment
Shaq Fu: A Legend Reborn - Big Deez Productions
DiRT 4 - Codemasters, Deep Silver
The Elder Scrolls Online: Morrowind - Bethesda Softworks
Perception - The Deep End Games
The Town of Light - LKA Interactive, LKA
'Mirror''s Edge Catalyst' - EA DICE
In Between - Gentlymad
'Super Ultra Dead Rising 3'' Arcade Remix Hyper Edition EX Plus Alpha' - Capcom Vancouver
The Elder Scrolls Online: Tamriel Unlimited - ZeniMax Media
Unravel Two - Coldwood Interactive
'Sherlock Holmes: The Devil''s Daughter' - Frogwares
Prey: Mooncrash - Arkane Studios
LEGO Jurassic World - TT Games
Jurassic World Evolution - Frontier Developments
Super Bomberman R - Konami
Trials of the Blood Dragon - RedLynx
Cars 3: Driven to Win - Avalanche Software
LEGO The Incredibles - TT Games
Payday 2: Crimewave Edition - Overkill Software
EA Sports UFC - EA Sports
Sixty Second Shooter Prime - Happion Laboratories
Dead by Daylight - 505 Games
Pac-Man 256 - HIPSTER WHALE
'Deadlight: Director''s Cut' - Tequila Works
MXGP2: The Official Motocross Videogame - Milestone S.r.l
Mighty No. 9 - Inti Creates
Yet Another Zombie Defense HD - Awesome Games Studio
Batman: Arkham Knight - Rocksteady Studios
Devil May Cry 4: Special Edition - Capcom
Get Even - The Farm 51
Transformers: Rise of the Dark Spark - Edge of Reality
Heart&Slash - AHEARTFULOFGAMES
Valiant Hearts: The Great War - Ubisoft Montpellier
NieR: Automata - Become as Gods Edition - PlatinumGames
The Awesome Adventures of Captain Spirit - DONTNOD Entertainment
The Crew 2 - Ubisoft Ivory Tower
The Golf Club 2 - HB Studios Multimedia, Maximum Games
Valkyria Revolution - SegaSoft, Sega
LEGO Star Wars: The Force Awakens - TT Games
Resident Evil 5 - Capcom
'Tom Clancy''s The Division - Underground' - Massive Entertainment
The Technomancer - Spiders
7 Days to Die - The Fun Pimps
INSIDE - PLAYDEAD
Lost Sea - EastAsiaSoft
Crash Bandicoot N. Sane Trilogy - Vicarious Visions
Marvel Heroes Omega - Gazillion
Micro Machines World Series - Codemasters, Just Add Water
AereA - Triangle Studios, Soedesco
Dead or Alive 6 - Team Ninja, Koei Tecmo Games
ToeJam & Earl: Back in the Groove - Humanature Studios
Pit People - The Behemoth
Mulaka - Lienzo
ScreamRide - Frontier Developments
Project Spark - Microsoft Game Studios
Resident Evil: Revelations 2 - Episode 2: Contemplation - Capcom
Shiftlings - Rock Pocket Games
The Occupation - White Paper Games
Zombie Army Trilogy - Rebellion
White Night - OSome Studio
TT Isle of Man: Ride On The Edge - Kylotonn, Maximum Games
Fear Effect Sedna - Sushee
'Tom Clancy''s Ghost Recon: Wildlands' - Ubisoft Paris
LEGO Worlds - TT Games
Way of the Passive Fist - Household Games Inc.
'Tom Clancy''s The Division' - Massive Entertainment
Verdun - Abstraction Games, M2H, Blackmill Games
Devil May Cry 5 - Capcom
DmC: Devil May Cry Definitive Edition - Ninja Theory, QLOC
Far Cry 4: Valley of the Yetis - Ubisoft Montreal
Table Top Racing: World Tour - Playrise Digital
2Dark - Gloomywood
Titanfall - Respawn Entertainment
Ori and the Blind Forest - Moon Studios
Resident Evil: Revelations 2 - Episode 3: Judgment - Capcom
Ori and the Blind Forest: Definitive Edition - Moon Studios
Hitman - Intro Pack - Io Interactive
MagNets: Fully Charged - Total Monkery
'Tom Clancy''s The Division 2' - Massive Entertainment
LA Cops - Modern Dream
The Council - Episode 1: The Mad Ones - Big Bad Wolf
Q.U.B.E. 2 - Toxic Games
Pure Farming 2018 - Techland
Devil May Cry HD Collection - Pipeworks Software, Inc., NeoBards Entertainment
Styx: Shards of Darkness - Cyanide
EA Sports UFC 2 - EA Sports
Surviving Mars - Haemimont Games
One Piece: World Seeker - Ganbarion
'Shantae and the Pirate''s Curse' - WayForward
Dungeon of the Endless - Amplitude Studios
Shadow Complex Remastered - Chair Entertainment
Burnout Paradise Remastered - Criterion Games, STELLAR ENTERTAINMENT SOFTWARE LTD
Tesla vs Lovecraft - 10tons
Resident Evil: Revelations 2 - Capcom
Final Fantasy Type-0 HD - HexaDrive
Battlefield Hardline - Visceral Games
FlatOut 4: Total Insanity - Strategy First, Kylotonn
Metal Gear Solid V: Ground Zeroes - Kojima Productions
Dead Rising 3: The Last Agent - Capcom Vancouver
Resident Evil: Revelations 2 - Episode 4: Metamorphosis - Capcom
Fruit Ninja Kinect 2 - Halfbrick Studios
Attack on Titan 2 - Omega Force
'Assassin''s Creed Rogue Remastered' - Ubisoft
Sea of Thieves - Rare Ltd.
Titan Quest - THQ Nordic
Mass Effect: Andromeda - BioWare
Trackmania Turbo - Nadeo
Fallout 4: Automatron - Bethesda Game Studios
Stranger of Sword City - Experience Inc.
Sekiro: Shadows Die Twice - From Software
A Way Out - Hazelight
Borderlands: The Handsome Collection - Gearbox Software, Iron Galaxy Studios
Game of Thrones: Episode Three - The Sword in the Darkness - Telltale Games
Life is Strange: Episode 2 - Out of Time - DONTNOD Entertainment
Forza Horizon 2 Presents Fast & Furious - Playground Games
Far Cry 5 - Ubisoft Montreal
Vikings: Wolves of Midgard - Games Farm
Killer Instinct Season 3 - Iron Galaxy Studios
Resident Evil 6 - Capcom
Snake Pass - Sumo Digital
Active Soccer 2 DX - The Fox Software
Thimbleweed Park - Ron Gilbert and Gary Winnick
Call of Duty: Advanced Warfare - Ascendance - Sledgehammer Games
Neverwinter - Cryptic Studios
The Inner World - Headup Games
Super Mega Baseball 2 - Metalhead Software
Through the Woods - Antagonist
SUPERHOT - SUPERHOT
Battleborn - Gearbox Software
The Park - Funcom
Wolfenstein: The Old Blood - MachineGames
Prey - Arkane Studios
City of Brass - Uppercut Games Pty Ltd
Coffin Dodgers - Milky Tea Studios
Conan Exiles - Funcom
Destiny 2: Warmind - Bungie
Forza Horizon 3: Hot Wheels - Playground Games
NBA Playgrounds - Saber Interactive
AO International Tennis - Big Ant Studios
BUTCHER - Crunching Koalas
Laser League - roll7
Raiden V - Moss
Project CARS - Slightly Mad Studios
Human: Fall Flat - No Brakes Games
Lifeless Planet: Premier Edition - Stage 2 Studios
DOOM - id Software
GunWorld 2 - M07 Games
Super Time Force - Capy Games
Titanfall: Expedition - Respawn Entertainment
N.E.R.O.: Nothing Ever Remains Obscure - Storm in a Teacup
Forgotton Anne - Throughline Games
Injustice 2 - NetherRealm Studios
The Surge - Deck 13
Homefront: The Revolution - Deep Silver Dambuster Studios
State of Decay 2 - Undead Labs
The Witcher 3: Wild Hunt - CD Projekt Red Studio
Life is Strange: Episode 3 - Chaos Theory - DONTNOD Entertainment
Fallout 4: Far Harbor - Bethesda Game Studios
Shadow Warrior 2 - Flying Wild Hog
Skylar & Plux: Adventure on Clover Island - Right Nice Games
Wolfenstein: The New Order - MachineGames
Mega Coin Squad - Big Pixel Studios
Spy Chameleon - Unfinished Pixel
Tennis World Tour - Bigben Interactive
Overwatch - Blizzard Entertainment
Portal Knights - 505 Games, Keen Games
OlliOlli2: XL Edition - roll7
Not A Hero: Super Snazzy Edition - roll7
Tropico 5 Penultimate Edition - Kalypso
Teenage Mutant Ninja Turtles: Mutants in Manhattan - PlatinumGames
Unit 4 - Gamera Games, Gamera Interactive
Dark Souls Remastered - From Software
oOo: Ascension - Kenny Creanor
Game of Thrones: Episode Four - Sons of Winter - Telltale Games
RiME - Tequila Works
Friday the 13th: The Game - IllFonic, Gun Media
Watch Dogs - Ubisoft Montreal
BADLAND: Game of the Year Edition - Frogmind
Moonlighter - 11 bit studios, Digital Sun
'Yoku''s Island Express' - Villa Gorilla
Street Fighter: 30th Anniversary Collection - Capcom
Sega Genesis Classics - Various
Agony - Madmind Studio
Worms Battlegrounds - Team 17
Victor Vran: Overkill Edition - Haemimont Games
The Walking Dead: The Telltale Series - A New Frontier Episode 5: From The Gallows - Telltale Games
FOX n FORESTS - Bonus Level Entertainment
Dead Island: Definitive Collection - Techland
One Piece: Burning Blood - Spike Chunsoft
Tokyo 42 - SMAC Games
Super Dungeon Bros - React Games
Call of Duty: Advanced Warfare - Sledgehammer Games
Need for Speed - Ghost Games
'The Peanuts Movie: Snoopy''s Grand Adventure' - Activision, Behaviour Interactive
Call of Duty: WWII - Sledgehammer Games
Call of Duty: Infinite Warfare - Infinity Ward
Gas Guzzlers Extreme - Iceberg Interactive
Call of Duty: Black Ops III - Treyarch
World of Final Fantasy Maxima - Square Enix
GRIP: Combat Racing - Caged Element Inc.
Assault Android Cactus - Witch Beam
'Super Lucky''s Tale' - Playful Corp.
Sonic Forces - SegaSoft, Sonic Team
Need for Speed Payback - Ghost Games
Hitman 2 - Io Interactive
11-11: Memories Retold - Digixart Entertainment
Fallout 4 - Bethesda Game Studios
Rise of the Tomb Raider - Crystal Dynamics
Dishonored 2 - Arkane Studios
Halo: The Master Chief Collection - 343 Industries
Pro Evolution Soccer 2015 - Konami
LEGO Batman 3: Beyond Gotham - TT Games
'Assassin''s Creed Unity' - Ubisoft, Ubisoft Montreal
NBA 2K14 - Visual Concepts
Spyro Reignited Trilogy - Activision, Toys for Bob
Pure Pool - VooFoo Studios
L.A. Noire - Team Bondi
LEGO Marvel Super Heroes 2 - TT Games
Fallout 76 - Bethesda Game Studios
Watch Dogs 2 - Ubisoft Montreal
'Assassin''s Creed: The Ezio Collection' - Ubisoft Montreal
Silence: The Whispered World 2 - Daedalic Entertainment
Battlefield V - EA DICE
Knight Squad - Chainsawesome Games
Game of Thrones: Episode Six - The Ice Dragon - Telltale Games
Star Wars Battlefront - EA DICE
Star Wars Battlefront II - EA DICE
The Sims 4 - Maxis
Grand Theft Auto V - Rockstar North
Minecraft: Xbox One Edition - 4J Studios, Mojang AB
Dragon Age: Inquisition - BioWare
Far Cry 4 - Ubisoft Montreal
WWE 2K15 - 'Yuke''s'
Rabbids Invasion - Ubisoft
FIFA 14 - EA Canada
Call of Duty: Ghosts - Infinity Ward
Madden NFL 25 - EA Sports
NBA Live 14 - EA Sports
Fighter Within - Ubisoft
Never Alone - Upper One Games
Bendy and the Ink Machine - TheMeatly Games
Forza Motorsport 5 - Turn 10
Dead Rising 3 - Capcom Vancouver
Need for Speed: Rivals - Ghost Games
Killer Instinct - Double Helix Games
Zoo Tycoon - Frontier Developments
Powerstar Golf - Zoe Mode
Ryse: Son of Rome - Crytek
Crimson Dragon - Grounding Inc.
LocoCycle - Twisted Pixel Games
Darksiders: Warmastered Edition - Nordic Games Publishing
Batman: The Telltale Series - Episode 4: Guardian of Gotham - Telltale Games
Minecraft: Story Mode - Episode 3: The Last Place You Look - Telltale Games
Geometry Wars 3: Dimensions - Lucid Games
Tales From The Borderlands: Episode 1 - Zer0 Sum - Telltale Games
Three Fourths Home: Extended Edition - [bracket]games
Darksiders III - Gunfire Games, THQ Nordic
Black Mirror - THQ Nordic
Final Fantasy XV - Square Enix
RIDE 3 - MileStone Inc., Milestone S.r.l
Chariot - Frima Studio
'Assassin''s Creed Odyssey' - Ubisoft
Mega Man 11 - Capcom
Battle Chasers: Nightwar - Airship Syndicate Entertainment
'Dragon''s Dogma: Dark Arisen' - Capcom
Warhammer: End Times - Vermintide - Fatshark AB, Nordic Games Publishing
N++ - Metanet Software Inc.
Skylanders Trap Team - Toys for Bob
WWE 2K19 - 'Yuke''s, Visual Concepts'
Elite: Dangerous - Frontier Developments
Rock Band 4 - Harmonix Music Systems
Transformers: Devastation - PlatinumGames
RIDE - Milestone S.r.l
NBA 2K15 - Visual Concepts
Alien: Isolation - Creative Assembly
Teslapunk - klutzGames
WRC 6: World Rally Championship - Kylotonn
Mafia III - Hangar 13
Styx: Master of Shadows - Cyanide
Space Hulk: Tactics - Cyanide, Cyanide Studios
Middle-earth: Shadow of War - Monolith Productions
'Marvel''s Guardians of the Galaxy - Episode 4: Who Needs You' - Telltale Games
Danger Zone - Three Fields Entertainment
Raid: World War II - Starbreeze
Gears of War 4 - The Coalition
WWE 2K17 - 'Yuke''s'
The Missing: JJ Macfield and the Island of Memories - White Owls
Mantis Burn Racing - VooFoo Studios
Call of Duty: Black Ops 4 - Treyarch
'Wasteland 2: Director''s Cut' - InXile Entertainment
Minecraft: Story Mode - Episode 1: The Order of the Stone - Telltale Games
The Evil Within 2 - Tango Gameworks
WWE 2K18 - 'Yuke''s'
The Evil Within - Tango Gameworks
Sleeping Dogs: Definitive Edition - United Front Games
Crimsonland - 10tons Entertainment, 10tons
Manual Samuel - Perfectly Paranormal
Skylanders Imaginators - Toys for Bob
Starlink: Battle for Atlas - Ubisoft Toronto
LEGO DC Super-Villains - TT Games
Warriors Orochi 4 - Koei Tecmo Games
NBA 2K Playgrounds 2 - Saber Interactive
South Park: The Fractured But Whole - Ubisoft San Francisco
Elex - Piranha Bytes
Rogue Trooper Redux - Sold Out
Battlefield 1 - EA DICE
Rock Band Rivals - Harmonix Music Systems
Sinner: Sacrifice for Redemption - DarkStar Games
SoulCalibur VI - Bandai Namco Games, Project Soul
Guitar Hero Live - FreeStyleGames
Life is Strange: Episode 5 - Polarized - DONTNOD Entertainment
Just Dance 2016 - Ubisoft
Adventure Time: Finn and Jake Investigations - Vicious Cycle
Fantasia: Music Evolved - Harmonix Music Systems
Shadow Warrior - Flying Wild Hog
Just Dance 2015 - Ubisoft
The Legend of Korra - PlatinumGames
'Assassin''s Creed Syndicate' - Ubisoft Quebec
Just Dance 2019 - Ubisoft Paris
Nickelodeon Kart Racers - GameMill Entertainment
Just Dance 2017 - Ubisoft Paris
Batman: The Telltale Series - Episode 3: New World Order - Telltale Games
Dragon Ball: Xenoverse 2 - Dimps Corporation
AER: Memories of Old - Daedalic Entertainment
Red Dead Redemption 2 - Rockstar Games
Divinity: Original Sin Enhanced Edition - Larian Studios Games Ltd
Halo 5: Guardians - 343 Industries
WWE 2K16 - 'Yuke''s'
Minecraft: Story Mode - Episode 2: Assembly Required - Telltale Games
Wolfenstein II: The New Colossus - MachineGames
'Assassin''s Creed Origins' - Ubisoft, Ubisoft Montreal
Sunset Overdrive - Insomniac Games
Lords of the Fallen - City Interactive, Deck 13
NBA Live 15 - EA Sports
Titanfall 2 - Respawn Entertainment
The Elder Scrolls V: Skyrim Special Edition - Bethesda Game Studios
ClusterTruck - tinyBuild
Darksiders II: Deathinitive Edition - Gunfire Games, Kaiko
Call of Cthulhu - Cyanide, Cyanide Studios
Spintires: Mudrunner - Maximum Games
Rush: A Disney / Pixar Adventure - Asobo Studio
Disneyland Adventures - Asobo Studio
Metal Gear Solid V: The Phantom Pain - Kojima Productions, Moby Dick Studio
Mad Max - Avalanche Studios
Earthlock: Festival of Magic - Snow Castle Games
Dance Central Spotlight - Harmonix Music Systems
Warriors Orochi 3 Ultimate - Omega Force
The Final Station - tinyBuild, Do My Best Games
'Broken Sword 5: The Serpent''s Curse' - Revolution Software
Destiny 2: Forsaken - Bungie Software, Bungie
'PlayerUnknown''s Battlegrounds' - Bluehole, Inc.
Planet Alpha - Adrian Lazar
Claire: Extended Cut - Hailstorm Games Inc
Destiny 2 - Bungie
Awesomenauts Assemble! - Abstraction Games, Ronimo Games
Oceanhorn: Monster of Uncharted Seas - Cornfox & Bros.
NBA 2K19 - Visual Concepts
NBA Live 19 - EA Sports, EA Tiburon
NASCAR Heat 3 - 704Games
Immortal: Unchained - Toadman Interactive
Destiny - Bungie Software, Bungie
NHL 15 - EA Sports
Castle Crashers Remastered - The Behemoth
Lovers in a Dangerous Spacetime - Asteroid Base
Jotun: Valhalla Edition - Thunder Lotus Games
'Leo''s Fortune' - 1337 & Senri LLC
NHL 19 - EA Sports
V-Rally 4 - Kylotonn
Pro Evolution Soccer 2018 - Konami
NHL 18 - EA Sports
Shadow of the Tomb Raider - Eidos Montreal
Pro Evolution Soccer 2017 - Konami
The Witness - Thekla, Inc
BioShock: The Collection - 2K Games
NHL 17 - EA Canada, EA Vancouver
Pac-Man Championship Edition 2 - Bandai Namco Games
ReCore - Armature Studio, comcept
Destiny: The Taken King - Bungie Software, Bungie
Forza Motorsport 6 - Turn 10
Pro Evolution Soccer 2016 - Konami
NHL 16 - EA Sports, EA Canada
NBA 2K18 - 2K Games
Dishonored: Death of the Outsider - Arkane Studios
NBA Live 18 - EA Sports
WRC 7 - Kylotonn
NBA 2K17 - Visual Concepts
Mount & Blade: Warband - Taleworlds
The Book of Unwritten Tales 2 - KING Art
'Capcom Beat ''Em Up Bundle' - Capcom
Transference - SpectreVision
'D4: Dark Dreams Don''t Die' - Access Games
Flockers - Team 17
Marvel vs. Capcom: Infinite - Capcom
Skylanders SuperChargers - Vicarious Visions
Batman: The Telltale Series - Episode 2: Children of Arkham - Telltale Games
Destiny: Rise of Iron - Bungie
Dear Esther: Landmark Edition - The Chinese Room
Super Hydorah - Locomalito
Firewatch - Campo Santo
My Brother Rabbit - Artifex Mundi
FIFA 16 - EA Sports
Blood Bowl 2 - Cyanide
Virginia - 505 Games
Project CARS 2 - Bandai Namco Games, Slightly Mad Studios
The LEGO NINJAGO Movie Video Game - TT Games
Raiders of the Broken Planet - Mercury Steam
FIFA 15 - EA Sports
Disney Infinity 2.0 Edition - Avalanche Software
Forza Horizon 3 - Playground Games
The Bunker - Splendy Games
DG2: Defense Grid 2 - Hidden Path Entertainment
NBA 2K16 - Visual Concepts
Guns, Gore & Cannoli - Claeys Brothers Arts
FIFA 19 - EA Sports
Dakar 18 - Bigmoon Entertainment
FIFA 18 - EA Vancouver
Ruiner - Reikon Games
LEGO Dimensions - 'Traveller''s Tales'
XCOM 2 - Firaxis Games
FIFA 17 - EA Sports, EA Vancouver
Life is Strange 2: Episode 1 - Roads - DONTNOD Entertainment
Forza Horizon 4 - Playground Games
NBA Live 16 - EA Sports
'Tony Hawk''s Pro Skater 5' - Robomodo
Cuphead - Studio MDHR
Forza Motorsport 7 - Turn 10
Middle-earth: Shadow of Mordor - Monolith Productions
Forza Horizon 2 - Playground Games
Sherlock Holmes: Crimes & Punishments - Frogwares
The Escapists: The Walking Dead - Team 17
